Origin,Destination,N_flights,Flight_time,Wait_time,Total_time,Exec_time
LDZA,ESKN,2,1150,110,1260,0.682
LDZA,ESKN,2,1158,97,1255,0.695
LDZA,ESKN,2,1092,154,1246,0.818
LDZA,ESKN,1,604,17,621,0.432
LDZA,ESKN,1,608,680,1288,0.814
LDZA,ESKN,2,1151,221,1372,0.627
LDZA,ESKN,1,604,19,623,0.458
LDZA,ESKN,1,608,313,921,0.587
LDZA,ESKN,2,1144,469,1613,0.442
LDZA,ESKN,1,608,161,769,0.485
LDZA,ESKN,2,1153,372,1525,0.488
LDZA,ESKN,2,1161,154,1315,0.663
LDZA,ESKN,2,1150,33,1183,0.623
LDZA,ESKN,1,604,495,1099,0.461
LDZA,ESKN,1,608,202,810,0.456
LDZA,ESKN,1,608,468,1076,0.633
LDZA,ESKN,2,1147,133,1280,0.559
LDZA,ESKN,2,1161,316,1477,0.445
LDZA,ESKN,1,608,51,659,0.472
LDZA,ESKN,1,604,582,1186,0.610
LDZA,ESKN,2,1144,141,1285,0.749
LDZA,ESKN,2,1157,319,1476,0.524
LDZA,ESKN,1,608,539,1147,0.419
LDZA,ESKN,2,1093,367,1460,0.694
LDZA,ESKN,2,1147,66,1213,0.555
LDZA,ESKN,2,1158,100,1258,0.557
LDZA,ESKN,2,1144,296,1440,0.456
LDZA,ESKN,1,608,176,784,0.513
LDZA,ESKN,2,1154,278,1432,0.434
LDZA,ESKN,2,1154,192,1346,0.758
LDZA,ESKN,2,1150,324,1474,0.822
LDZA,ESKN,1,608,574,1182,0.503
LDZA,ESKN,1,608,107,715,0.597
LDZA,ESKN,2,1092,259,1351,0.581
LDZA,ESKN,2,1144,67,1211,0.469
LDZA,ESKN,2,1166,121,1287,0.709
LDZA,ESKN,2,1158,124,1282,0.515
LDZA,ESKN,1,604,643,1247,0.457
LDZA,ESKN,2,1151,271,1422,0.453
LDZA,ESKN,2,1154,95,1249,0.767
LDZA,ESKN,2,1267,108,1375,0.698
LDZA,ESKN,2,1150,195,1345,0.465
LDZA,ESKN,2,1161,174,1335,0.575
LDZA,ESKN,1,604,286,890,0.507
LDZA,ESKN,2,1163,369,1532,0.794
LDZA,ESKN,1,604,467,1071,0.923
LDZA,ESKN,2,1150,197,1347,0.627
LDZA,ESKN,1,604,199,803,0.505
LDZA,ESKN,2,1092,255,1347,0.471
LDZA,ESKN,1,604,319,923,0.500
LDZA,ESKN,1,608,401,1009,0.885
LDZA,ESKN,2,1154,54,1208,0.790
LDZA,ESKN,2,1092,152,1244,0.880
LDZA,ESKN,1,608,741,1349,0.801
LDZA,ESKN,2,1157,111,1268,0.935
LDZA,ESKN,1,608,224,832,0.849
LDZA,ESKN,1,608,456,1064,0.555
LDZA,ESKN,2,1092,440,1532,0.858
LDZA,ESKN,1,608,277,885,0.848
LDZA,ESKN,1,608,379,987,0.515
LDZA,ESKN,2,1157,151,1308,0.822
LDZA,ESKN,2,1163,432,1595,0.441
LDZA,ESKN,1,608,524,1132,0.472
LDZA,ESKN,2,1150,129,1279,0.473
LDZA,ESKN,2,1154,145,1299,0.558
LDZA,ESKN,2,1151,358,1509,0.465
LDZA,ESKN,2,1155,214,1369,0.730
LDZA,ESKN,1,604,279,883,0.465
LDZA,ESKN,1,608,356,964,0.460
LDZA,ESKN,2,1267,86,1353,0.565
LDZA,ESKN,2,1150,128,1278,0.688
LDZA,ESKN,1,608,588,1196,0.456
LDZA,ESKN,2,1151,216,1367,0.619
LDZA,ESKN,1,608,652,1260,0.776
LDZA,ESKN,1,608,47,655,0.460
LDZA,ESKN,2,1150,116,1266,0.488
LDZA,ESKN,2,1144,314,1458,0.753
LDZA,ESKN,2,1267,155,1422,0.456
LDZA,ESKN,1,604,24,628,0.839
LDZA,ESKN,2,1153,147,1300,0.582
LDZA,ESKN,1,608,327,935,0.691
LDZA,ESKN,2,1267,170,1437,0.460
LDZA,ESKN,1,608,679,1287,0.572
LDZA,ESKN,1,604,706,1310,0.475
LDZA,ESKN,2,1151,187,1338,0.454
LDZA,ESKN,2,1092,274,1366,0.601
LDZA,ESKN,2,1144,85,1229,0.832
LDZA,ESKN,1,608,161,769,0.474
LDZA,ESKN,2,1144,105,1249,0.718
LDZA,ESKN,2,1166,205,1371,0.452
LDZA,ESKN,2,1151,148,1299,0.453
LDZA,ESKN,2,1153,245,1398,0.835
LDZA,ESKN,2,1092,258,1350,0.477
LDZA,ESKN,2,1155,302,1457,0.481
LDZA,ESKN,1,604,497,1101,0.437
LDZA,ESKN,1,604,182,786,0.662
LDZA,ESKN,2,1151,256,1407,0.661
LDZA,ESKN,2,1157,360,1517,0.601
LDZA,ESKN,2,1155,420,1575,0.515
LDZA,ESKN,1,608,675,1283,0.467
LDZA,ESKN,2,1155,410,1565,0.549
LDZA,ESKN,2,1150,43,1193,0.452
LDZA,ESKN,1,604,408,1012,0.471
LDZA,ESKN,1,604,228,832,0.521
LDZA,ESKN,2,1151,263,1414,0.626
LDZA,ESKN,2,1150,288,1438,0.525
LDZA,ESKN,2,1161,203,1364,0.578
LDZA,ESKN,1,608,183,791,0.517
LDZA,ESKN,2,1153,175,1328,0.544
LDZA,ESKN,2,1154,247,1401,0.827
LDZA,ESKN,2,1166,102,1268,0.922
LDZA,ESKN,2,1155,134,1289,0.526
LDZA,ESKN,2,1092,250,1342,0.699
LDZA,ESKN,2,1161,147,1308,0.449
LDZA,ESKN,1,604,488,1092,0.406
LDZA,ESKN,2,1157,156,1313,0.729
LDZA,ESKN,1,608,709,1317,0.535
LDZA,ESKN,1,604,350,954,0.676
LDZA,ESKN,2,1158,224,1382,0.565
LDZA,ESKN,1,604,389,993,0.467
LDZA,ESKN,2,1153,479,1632,0.461
LDZA,ESKN,2,1161,231,1392,0.449
LDZA,ESKN,1,608,791,1399,0.452
LDZA,ESKN,2,1158,167,1325,0.537
LDZA,ESKN,2,1153,231,1384,0.457
LDZA,ESKN,2,1150,178,1328,0.465
LDZA,ESKN,2,1151,236,1387,0.506
LDZA,ESKN,2,1157,37,1194,0.656
LDZA,ESKN,2,1154,287,1441,0.389
LDZA,ESKN,2,1144,244,1388,0.845
LDZA,ESKN,2,1151,305,1456,0.898
LDZA,ESKN,2,1150,132,1282,0.765
LDZA,ESKN,2,1091,319,1410,0.818
LDZA,ESKN,2,1151,202,1353,0.875
LDZA,ESKN,2,1092,218,1310,0.532
LDZA,ESKN,2,1150,78,1228,0.460
LDZA,ESKN,2,1166,269,1435,0.487
LDZA,ESKN,1,604,245,849,0.479
LDZA,ESKN,2,1091,407,1498,0.603
LDZA,ESKN,1,608,580,1188,0.555
LDZA,ESKN,2,1154,146,1300,0.767
LDZA,ESKN,2,1151,238,1389,0.649
LDZA,ESKN,1,604,198,802,0.579
LDZA,ESKN,1,604,423,1027,0.643
LDZA,ESKN,2,1150,126,1276,0.422
LDZA,ESKN,2,1155,279,1434,0.528
LDZA,ESKN,2,1155,427,1582,0.456
LDZA,ESKN,2,1267,120,1387,0.379
LDZA,ESKN,2,1154,254,1408,0.740
LDZA,ESKN,2,1158,140,1298,0.447
LDZA,ESKN,2,1092,348,1440,0.749
LDZA,ESKN,2,1092,99,1191,0.903
LDZA,ESKN,2,1155,122,1277,0.496
LDZA,ESKN,1,604,93,697,0.482
LDZA,ESKN,2,1151,406,1557,0.563
LDZA,ESKN,1,608,87,695,0.564
LDZA,ESKN,2,1157,302,1459,0.519
LDZA,ESKN,1,608,722,1330,0.485
LDZA,ESKN,2,1151,242,1393,0.498
LDZA,ESKN,2,1153,149,1302,0.568
LDZA,ESKN,2,1151,306,1457,0.470
LDZA,ESKN,2,1158,230,1388,0.435
LDZA,ESKN,1,604,64,668,0.408
LDZA,ESKN,1,608,473,1081,0.721
LDZA,ESKN,1,604,406,1010,0.429
LDZA,ESKN,2,1150,106,1256,0.458
LDZA,ESKN,1,608,737,1345,0.467
LDZA,ESKN,2,1151,246,1397,0.577
LDZA,ESKN,2,1151,370,1521,0.519
LDZA,ESKN,1,604,455,1059,0.572
LDZA,ESKN,1,604,160,764,0.471
LDZA,ESKN,2,1154,107,1261,0.449
LDZA,ESKN,2,1161,193,1354,0.429
LDZA,ESKN,2,1147,378,1525,0.454
LDZA,ESKN,2,1092,269,1361,0.493
LDZA,ESKN,1,608,445,1053,0.456
LDZA,ESKN,2,1150,380,1530,0.412
LDZA,ESKN,2,1158,244,1402,0.491
LDZA,ESKN,2,1154,214,1368,0.586
LDZA,ESKN,2,1151,140,1291,0.425
LDZA,ESKN,2,1150,190,1340,0.466
LDZA,ESKN,1,604,471,1075,0.819
LDZA,ESKN,1,608,138,746,0.807
LDZA,ESKN,1,608,511,1119,0.801
LDZA,ESKN,1,608,388,996,0.519
LDZA,ESKN,1,608,245,853,0.535
LDZA,ESKN,1,604,271,875,0.426
LDZA,ESKN,2,1153,168,1321,0.483
LDZA,ESKN,2,1091,335,1426,0.506
LDZA,ESKN,1,604,438,1042,0.421
LDZA,ESKN,2,1147,219,1366,0.458
LDZA,ESKN,2,1150,271,1421,0.419
LDZA,ESKN,2,1157,309,1466,0.553
LDZA,ESKN,2,1151,310,1461,0.559
LDZA,ESKN,2,1150,355,1505,0.508
LDZA,ESKN,1,608,804,1412,0.440
LDZA,ESKN,2,1151,179,1330,0.411
LDZA,ESKN,1,604,480,1084,0.397
LDZA,ESKN,1,608,639,1247,0.450
LDZA,ESKN,2,1092,282,1374,0.490
LDZA,ESKN,2,1166,291,1457,0.675
LDZA,ESKN,2,1155,220,1375,0.734
LDZA,ESKN,1,608,560,1168,0.474
LDZA,ESKN,1,604,575,1179,0.445
LDZA,ESKN,2,1158,128,1286,0.463
LDZA,ESKN,2,1157,31,1188,0.456
LDZA,ESKN,1,604,298,902,0.429
LDZA,ESKN,2,1144,187,1331,0.504
LDZA,ESKN,2,1147,239,1386,0.448
LDZA,ESKN,2,1144,243,1387,0.446
LDZA,ESKN,1,604,406,1010,0.764
LDZA,ESKN,2,1150,221,1371,0.482
LDZA,ESKN,2,1151,224,1375,0.497
LDZA,ESKN,1,608,408,1016,0.458
LDZA,ESKN,2,1092,255,1347,0.756
LDZA,ESKN,2,1147,182,1329,0.873
LDZA,ESKN,2,1092,284,1376,0.472
LDZA,ESKN,1,604,371,975,0.462
LDZA,ESKN,2,1091,374,1465,0.532
LDZA,ESKN,1,604,233,837,0.447
LDZA,ESKN,2,1092,220,1312,0.675
LDZA,ESKN,2,1091,351,1442,0.489
LDZA,ESKN,1,608,302,910,0.356
LDZA,ESKN,1,604,689,1293,0.439
LDZA,ESKN,2,1151,108,1259,0.418
LDZA,ESKN,1,608,594,1202,0.465
LDZA,ESKN,2,1157,279,1436,0.464
LDZA,ESKN,2,1092,178,1270,0.459
LDZA,ESKN,2,1151,199,1350,0.487
LDZA,ESKN,2,1147,34,1181,0.525
LDZA,ESKN,2,1153,154,1307,0.479
LDZA,ESKN,2,1150,87,1237,0.549
LDZA,ESKN,2,1158,174,1332,0.475
LDZA,ESKN,2,1267,140,1407,0.584
LDZA,ESKN,2,1150,87,1237,0.461
LDZA,ESKN,1,604,46,650,0.429
LDZA,ESKN,2,1144,39,1183,0.480
LDZA,ESKN,1,608,542,1150,0.441
LDZA,ESKN,2,1144,168,1312,0.534
LDZA,ESKN,2,1157,57,1214,0.525
LDZA,ESKN,1,608,675,1283,0.463
LDZA,ESKN,1,608,560,1168,0.462
LDZA,ESKN,1,604,203,807,0.446
LDZA,ESKN,2,1150,92,1242,0.449
LDZA,ESKN,2,1158,164,1322,0.481
LDZA,ESKN,2,1155,405,1560,0.400
LDZA,ESKN,2,1150,201,1351,0.477
LDZA,ESKN,1,604,97,701,0.550
LDZA,ESKN,2,1150,366,1516,0.769
LDZA,ESKN,1,608,234,842,0.573
LDZA,ESKN,2,1163,409,1572,0.488
LDZA,ESKN,2,1155,270,1425,0.468
LDZA,ESKN,2,1150,208,1358,0.528
LDZA,ESKN,1,604,306,910,0.371
LDZA,ESKN,2,1144,82,1226,0.502
LDZA,ESKN,2,1154,210,1364,0.518
LDZA,ESKN,2,1150,230,1380,0.704
LDZA,ESKN,2,1150,329,1479,0.590
LDZA,ESKN,2,1166,229,1395,0.481
LDZA,ESKN,2,1097,274,1371,0.824
LDZA,ESKN,2,1155,385,1540,0.887
LDZA,ESKN,2,1267,71,1338,0.826
LDZA,ESKN,2,1144,137,1281,0.448
LDZA,ESKN,1,604,480,1084,0.453
LDZA,ESKN,1,608,202,810,0.454
LDZA,ESKN,1,608,311,919,0.598
LDZA,ESKN,1,608,484,1092,0.456
LDZA,ESKN,2,1157,305,1462,0.461
LDZA,ESKN,1,608,278,886,0.513
LDZA,ESKN,1,604,382,986,0.445
LDZA,ESKN,2,1151,113,1264,0.441
LDZA,ESKN,2,1155,405,1560,0.349
LDZA,ESKN,2,1154,189,1343,0.468
LDZA,ESKN,2,1147,55,1202,0.520
LDZA,ESKN,2,1144,199,1343,0.633
LDZA,ESKN,2,1150,196,1346,0.651
LDZA,ESKN,2,1091,348,1439,0.623
LDZA,ESKN,2,1150,88,1238,0.634
LDZA,ESKN,2,1151,199,1350,0.513
LDZA,ESKN,2,1144,210,1354,0.524
LDZA,ESKN,1,604,151,755,0.544
LDZA,ESKN,2,1144,250,1394,0.453
LDZA,ESKN,2,1150,89,1239,0.788
LDZA,ESKN,2,1166,135,1301,0.865
LDZA,ESKN,2,1144,290,1434,0.763
LDZA,ESKN,1,608,39,647,0.757
LDZA,ESKN,2,1158,88,1246,0.470
LDZA,ESKN,2,1158,224,1382,0.774
LDZA,ESKN,2,1157,73,1230,0.526
LDZA,ESKN,2,1144,122,1266,0.510
LDZA,ESKN,2,1151,186,1337,0.485
LDZA,ESKN,1,604,18,622,0.465
LDZA,ESKN,1,604,388,992,0.495
LDZA,ESKN,2,1092,362,1454,0.537
LDZA,ESKN,1,608,607,1215,0.919
LDZA,ESKN,2,1144,256,1400,0.654
LDZA,ESKN,1,608,446,1054,0.615
LDZA,ESKN,1,604,460,1064,0.443
LDZA,ESKN,2,1144,210,1354,0.472
LDZA,ESKN,2,1158,81,1239,0.706
LDZA,ESKN,2,1144,306,1450,0.504
LDZA,ESKN,2,1144,213,1357,0.472
LDZA,ESKN,2,1144,76,1220,0.550
LDZA,ESKN,1,608,468,1076,0.700
LDZA,ESKN,2,1147,172,1319,0.566
LDZA,ESKN,2,1158,97,1255,0.462
LDZA,ESKN,1,608,289,897,0.537
LDZA,ESKN,2,1092,208,1300,0.697
LDZA,ESKN,2,1158,87,1245,0.518
LDZA,ESKN,1,608,164,772,0.452
LDZA,ESKN,2,1091,294,1385,0.484
LDZA,ESKN,2,1163,442,1605,0.451
LDZA,ESKN,2,1158,100,1258,0.500
LDZA,ESKN,2,1155,341,1496,0.445
LDZA,ESKN,2,1092,171,1263,0.688
LDZA,ESKN,1,604,572,1176,0.378
LDZA,ESKN,1,604,237,841,0.525
LDZA,ESKN,2,1144,41,1185,0.523
LDZA,ESKN,2,1166,198,1364,0.479
LDZA,ESKN,2,1166,337,1503,0.477
LDZA,ESKN,2,1153,230,1383,0.502
LDZA,ESKN,2,1151,275,1426,0.668
LDZA,ESKN,1,604,108,712,0.645
LDZA,ESKN,1,608,203,811,0.548
LDZA,ESKN,2,1166,217,1383,0.457
LDZA,ESKN,2,1155,256,1411,0.507
LDZA,ESKN,2,1144,150,1294,0.507
LDZA,ESKN,2,1155,346,1501,0.834
LDZA,ESKN,1,608,256,864,0.797
LDZA,ESKN,1,608,389,997,0.498
LDZA,ESKN,1,608,406,1014,0.514
LDZA,ESKN,2,1144,298,1442,0.424
LDZA,ESKN,1,608,676,1284,0.440
LDZA,ESKN,2,1092,123,1215,0.821
LDZA,ESKN,1,604,397,1001,0.820
LDZA,ESKN,1,608,552,1160,0.595
LDZA,ESKN,2,1092,128,1220,0.474
LDZA,ESKN,2,1150,206,1356,0.450
LDZA,ESKN,1,608,299,907,0.487
LDZA,ESKN,1,604,52,656,0.754
LDZA,ESKN,1,608,482,1090,0.521
LDZA,ESKN,2,1144,192,1336,0.767
LDZA,ESKN,2,1267,208,1475,0.453
LDZA,ESKN,2,1144,56,1200,0.454
LDZA,ESKN,2,1154,137,1291,0.528
LDZA,ESKN,2,1267,71,1338,0.475
LDZA,ESKN,1,604,114,718,0.797
LDZA,ESKN,2,1155,296,1451,0.534
LDZA,ESKN,2,1161,224,1385,0.339
LDZA,ESKN,1,604,118,722,0.441
LDZA,ESKN,2,1092,362,1454,0.798
LDZA,ESKN,2,1158,140,1298,0.798
LDZA,ESKN,2,1155,321,1476,0.780
LDZA,ESKN,1,604,100,704,0.454
LDZA,ESKN,2,1163,336,1499,0.466
LDZA,ESKN,1,604,17,621,0.436
LDZA,ESKN,2,1150,103,1253,0.509
LDZA,ESKN,1,608,192,800,0.451
LDZA,ESKN,2,1144,294,1438,0.470
LDZA,ESKN,2,1147,61,1208,0.814
LDZA,ESKN,2,1150,141,1291,0.453
LDZA,ESKN,1,608,376,984,0.493
LDZA,ESKN,1,608,367,975,0.811
LDZA,ESKN,2,1144,104,1248,0.676
LDZA,ESKN,1,608,7,615,0.377
LDZA,ESKN,2,1151,127,1278,0.478
LDZA,ESKN,1,604,387,991,0.489
LDZA,ESKN,1,608,414,1022,0.798
LDZA,ESKN,2,1166,226,1392,0.723
LDZA,ESKN,1,604,546,1150,0.509
LDZA,ESKN,1,604,287,891,0.480
LDZA,ESKN,1,604,574,1178,0.402
LDZA,ESKN,2,1154,137,1291,0.453
LDZA,ESKN,1,608,137,745,0.437
LDZA,ESKN,1,604,377,981,0.456
LDZA,ESKN,2,1147,112,1259,0.510
LDZA,ESKN,2,1166,127,1293,0.429
LDZA,ESKN,2,1092,225,1317,0.516
LDZA,ESKN,2,1151,246,1397,0.440
LDZA,ESKN,1,604,670,1274,0.564
LDZA,ESKN,1,608,196,804,0.461
LDZA,ESKN,1,608,182,790,0.507
LDZA,ESKN,2,1166,208,1374,0.452
LDZA,ESKN,2,1267,81,1348,0.509
LDZA,ESKN,2,1154,161,1315,0.690
LDZA,ESKN,2,1092,315,1407,0.572
LDZA,ESKN,1,608,825,1433,0.438
LDZA,ESKN,2,1092,143,1235,0.459
LDZA,ESKN,1,604,501,1105,0.464
LDZA,ESKN,1,604,177,781,0.381
LDZA,ESKN,2,1157,272,1429,0.465
LDZA,ESKN,1,604,104,708,0.433
LDZA,ESKN,2,1267,67,1334,0.644
LDZA,ESKN,2,1144,88,1232,0.479
LDZA,ESKN,1,608,838,1446,0.470
LDZA,ESKN,2,1157,383,1540,0.460
LDZA,ESKN,2,1155,200,1355,0.353
LDZA,ESKN,2,1150,186,1336,0.528
LDZA,ESKN,1,604,586,1190,0.500
LDZA,ESKN,1,608,504,1112,0.415
LDZA,ESKN,2,1158,168,1326,0.488
LDZA,ESKN,2,1267,99,1366,0.444
LDZA,ESKN,2,1151,250,1401,0.708
LDZA,ESKN,1,604,363,967,0.566
LDZA,ESKN,1,604,491,1095,0.502
LDZA,ESKN,2,1151,293,1444,0.492
LDZA,ESKN,1,608,718,1326,0.683
LDZA,ESKN,2,1151,370,1521,0.689
LDZA,ESKN,2,1161,137,1298,0.428
LDZA,ESKN,1,604,198,802,0.439
LDZA,ESKN,2,1161,300,1461,0.517
LDZA,ESKN,2,1092,215,1307,0.803
LDZA,ESKN,1,608,439,1047,0.797
LDZA,ESKN,1,608,677,1285,0.487
LDZA,ESKN,2,1152,369,1521,0.761
LDZA,ESKN,1,608,273,881,0.501
LDZA,ESKN,2,1151,109,1260,0.569
LDZA,ESKN,1,608,328,936,0.537
LDZA,ESKN,2,1150,124,1274,0.565
LDZA,ESKN,1,604,16,620,0.468
LDZA,ESKN,2,1151,180,1331,0.441
LDZA,ESKN,1,608,570,1178,0.680
LDZA,ESKN,2,1147,237,1384,0.440
LDZA,ESKN,2,1157,303,1460,0.535
LDZA,ESKN,2,1147,121,1268,0.461
LDZA,ESKN,1,604,106,710,0.446
LDZA,ESKN,1,604,151,755,0.623
LDZA,ESKN,2,1150,86,1236,0.423
LDZA,ESKN,1,608,615,1223,0.433
LDZA,ESKN,2,1144,191,1335,0.462
LDZA,ESKN,2,1150,163,1313,0.658
LDZA,ESKN,1,608,437,1045,0.583
LDZA,ESKN,2,1151,238,1389,0.498
LDZA,ESKN,2,1154,56,1210,0.441
LDZA,ESKN,2,1158,142,1300,0.439
LDZA,ESKN,2,1159,328,1487,0.816
LDZA,ESKN,1,608,515,1123,0.719
LDZA,ESKN,1,604,432,1036,0.460
LDZA,ESKN,1,608,274,882,0.461
LDZA,ESKN,1,608,751,1359,0.499
LDZA,ESKN,2,1151,114,1265,0.716
LDZA,ESKN,2,1092,81,1173,0.436
LDZA,ESKN,1,608,236,844,0.443
LDZA,ESKN,1,608,12,620,0.468
LDZA,ESKN,2,1151,280,1431,0.437
LDZA,ESKN,2,1267,131,1398,0.515
LDZA,ESKN,2,1150,386,1536,0.465
LDZA,ESKN,1,604,603,1207,0.770
LDZA,ESKN,2,1091,409,1500,0.668
LDZA,ESKN,2,1150,54,1204,0.451
LDZA,ESKN,1,604,248,852,0.448
LDZA,ESKN,1,608,158,766,0.462
LDZA,ESKN,1,608,619,1227,0.458
LDZA,ESKN,1,608,242,850,0.416
LDZA,ESKN,2,1158,281,1439,0.473
LDZA,ESKN,2,1151,324,1475,0.530
LDZA,ESKN,2,1150,150,1300,0.499
LDZA,ESKN,1,608,735,1343,0.529
LDZA,ESKN,2,1158,289,1447,0.416
LDZA,ESKN,1,608,649,1257,0.865
LDZA,ESKN,2,1092,280,1372,0.605
LDZA,ESKN,2,1091,335,1426,0.467
LDZA,ESKN,2,1157,296,1453,0.777
LDZA,ESKN,2,1150,104,1254,0.486
LDZA,ESKN,2,1150,312,1462,0.750
LDZA,ESKN,1,608,138,746,0.495
LDZA,ESKN,2,1147,266,1413,0.474
LDZA,ESKN,2,1150,421,1571,0.642
LDZA,ESKN,2,1150,449,1599,0.638
LDZA,ESKN,2,1144,295,1439,0.912
LDZA,ESKN,2,1158,130,1288,0.946
LDZA,ESKN,1,608,622,1230,0.785
LDZA,ESKN,2,1154,169,1323,0.767
LDZA,ESKN,2,1105,373,1478,0.828
LDZA,ESKN,2,1092,310,1402,0.779
LDZA,ESKN,1,608,69,677,0.755
LDZA,ESKN,1,604,344,948,0.822
LDZA,ESKN,2,1144,191,1335,0.513
LDZA,ESKN,2,1147,61,1208,0.552
LDZA,ESKN,2,1150,93,1243,0.524
LDZA,ESKN,1,608,789,1397,0.518
LDZA,ESKN,2,1092,236,1328,0.490
LDZA,ESKN,2,1092,164,1256,0.884
LDZA,ESKN,2,1154,248,1402,0.622
LDZA,ESKN,2,1157,322,1479,0.497
LDZA,ESKN,1,604,254,858,0.469
LDZA,ESKN,1,608,24,632,0.673
LDZA,ESKN,2,1152,449,1601,0.524
LDZA,ESKN,2,1150,93,1243,0.472
LDZA,ESKN,2,1144,38,1182,0.608
LDZA,ESKN,1,604,114,718,0.456
LDZA,ESKN,2,1150,105,1255,0.454
LDZA,ESKN,1,608,518,1126,0.463
LDZA,ESKN,2,1153,236,1389,0.435
LDZA,ESKN,2,1157,93,1250,0.447
LDZA,ESKN,2,1150,247,1397,0.430
LDZA,ESKN,2,1156,365,1521,0.815
LDZA,ESKN,2,1166,102,1268,0.449
LDZA,ESKN,1,604,518,1122,0.615
LDZA,ESKN,1,608,224,832,0.556
LDZA,ESKN,2,1092,216,1308,0.748
LDZA,ESKN,2,1157,97,1254,0.604
LDZA,ESKN,2,1147,41,1188,0.460
LDZA,ESKN,2,1151,370,1521,0.523
LDZA,ESKN,1,608,739,1347,0.524
LDZA,ESKN,2,1163,341,1504,0.558
LDZA,ESKN,2,1155,257,1412,0.446
LDZA,ESKN,2,1155,181,1336,0.453
LDZA,ESKN,1,604,104,708,0.491
LDZA,ESKN,2,1151,251,1402,0.794
LDZA,ESKN,2,1092,225,1317,0.611
LDZA,ESKN,2,1151,235,1386,0.685
LDZA,ESKN,1,608,618,1226,0.389
LDZA,ESKN,1,608,809,1417,0.659
LDZA,ESKN,2,1153,359,1512,0.496
LDZA,ESKN,1,608,707,1315,0.588
LDZA,ESKN,2,1144,42,1186,0.471
LDZA,ESKN,2,1151,129,1280,0.445
LDZA,ESKN,2,1152,473,1625,0.612
LDZA,ESKN,1,604,452,1056,0.416
LDZA,ESKN,1,604,148,752,0.566
LDZA,ESKN,2,1144,296,1440,0.486
LDZA,ESKN,1,608,129,737,0.456
LDZA,ESKN,1,608,794,1402,0.834
LDZA,ESKN,1,604,544,1148,0.803
LDZA,ESKN,1,608,112,720,0.564
LDZA,ESKN,1,608,583,1191,0.459
LDZA,ESKN,1,608,496,1104,0.466
LDZA,ESKN,1,604,707,1311,0.623
LDZA,ESKN,1,608,624,1232,0.453
LDZA,ESKN,1,608,433,1041,0.470
LDZA,ESKN,2,1158,120,1278,0.431
LDZA,ESKN,2,1154,184,1338,0.376
LDZA,ESKN,2,1267,77,1344,0.742
LDZA,ESKN,2,1092,112,1204,0.439
LDZA,ESKN,2,1166,225,1391,0.537
LDZA,ESKN,2,1092,351,1443,0.553
LDZA,ESKN,1,604,172,776,0.398
LDZA,ESKN,2,1144,250,1394,0.824
LDZA,ESKN,2,1092,259,1351,0.720
LDZA,ESKN,2,1147,52,1199,0.449
LDZA,ESKN,2,1158,155,1313,0.438
LDZA,ESKN,2,1151,250,1401,0.473
LDZA,ESKN,2,1150,311,1461,0.841
LDZA,ESKN,1,604,131,735,0.396
LDZA,ESKN,2,1147,104,1251,0.482
LDZA,ESKN,2,1157,272,1429,0.482
LDZA,ESKN,2,1166,218,1384,0.646
LDZA,ESKN,2,1147,20,1167,0.469
LDZA,ESKN,1,604,14,618,0.397
LDZA,ESKN,2,1154,251,1405,0.416
LDZA,ESKN,2,1092,161,1253,0.460
LDZA,ESKN,2,1150,182,1332,0.624
LDZA,ESKN,2,1267,147,1414,0.492
LDZA,ESKN,2,1144,292,1436,0.449
LDZA,ESKN,1,604,346,950,0.473
LDZA,ESKN,2,1158,291,1449,0.726
LDZA,ESKN,2,1092,228,1320,0.506
LDZA,ESKN,2,1144,131,1275,0.720
LDZA,ESKN,2,1158,178,1336,0.550
LDZA,ESKN,1,604,488,1092,0.858
LDZA,ESKN,1,608,31,639,0.532
LDZA,ESKN,2,1151,150,1301,0.829
LDZA,ESKN,2,1267,108,1375,0.792
LDZA,ESKN,1,608,148,756,0.525
LDZA,ESKN,2,1154,121,1275,0.508
LDZA,ESKN,2,1155,313,1468,0.465
LDZA,ESKN,2,1158,229,1387,0.506
LDZA,ESKN,2,1144,403,1547,0.438
LDZA,ESKN,2,1267,77,1344,0.857
LDZA,ESKN,1,608,554,1162,0.501
LDZA,ESKN,2,1150,362,1512,0.454
LDZA,ESKN,2,1144,146,1290,0.526
LDZA,ESKN,1,604,539,1143,0.590
LDZA,ESKN,2,1166,311,1477,0.465
LDZA,ESKN,2,1151,273,1424,0.478
LDZA,ESKN,2,1092,224,1316,0.483
LDZA,ESKN,2,1151,191,1342,0.450
LDZA,ESKN,2,1158,85,1243,0.528
LDZA,ESKN,1,608,203,811,0.511
LDZA,ESKN,2,1150,105,1255,0.605
LDZA,ESKN,1,604,575,1179,0.521
LDZA,ESKN,2,1154,143,1297,0.449
LDZA,ESKN,1,608,558,1166,0.417
LDZA,ESKN,2,1157,172,1329,0.647
LDZA,ESKN,2,1157,84,1241,0.547
LDZA,ESKN,2,1150,142,1292,0.587
LDZA,ESKN,2,1150,93,1243,0.739
LDZA,ESKN,2,1267,184,1451,0.789
LDZA,ESKN,2,1155,446,1601,0.617
LDZA,ESKN,2,1163,417,1580,0.838
LDZA,ESKN,1,608,660,1268,0.530
LDZA,ESKN,2,1091,436,1527,0.818
LDZA,ESKN,2,1147,17,1164,0.847
LDZA,ESKN,2,1153,131,1284,0.789
LDZA,ESKN,2,1151,283,1434,0.566
LDZA,ESKN,2,1155,329,1484,0.826
LDZA,ESKN,1,608,428,1036,0.463
LDZA,ESKN,1,608,688,1296,0.540
LDZA,ESKN,2,1267,131,1398,0.547
LDZA,ESKN,2,1157,304,1461,0.639
LDZA,ESKN,2,1158,172,1330,0.410
LDZA,ESKN,2,1157,16,1173,0.513
LDZA,ESKN,2,1151,240,1391,0.553
LDZA,ESKN,1,604,394,998,0.425
LDZA,ESKN,2,1158,315,1473,0.564
LDZA,ESKN,2,1150,120,1270,0.630
LDZA,ESKN,1,604,63,667,0.618
LDZA,ESKN,2,1154,70,1224,0.847
LDZA,ESKN,2,1144,283,1427,0.872
LDZA,ESKN,1,604,103,707,0.792
LDZA,ESKN,1,604,482,1086,0.875
LDZA,ESKN,2,1154,235,1389,0.703
LDZA,ESKN,1,604,563,1167,0.489
LDZA,ESKN,1,604,567,1171,0.781
LDZA,ESKN,1,608,761,1369,0.463
LDZA,ESKN,2,1163,415,1578,0.596
LDZA,ESKN,1,608,340,948,0.440
LDZA,ESKN,1,604,531,1135,0.450
LDZA,ESKN,1,604,167,771,0.591
LDZA,ESKN,2,1092,284,1376,0.459
LDZA,ESKN,2,1157,144,1301,0.692
LDZA,ESKN,2,1092,151,1243,0.766
LDZA,ESKN,2,1157,133,1290,0.528
LDZA,ESKN,1,608,115,723,0.534
LDZA,ESKN,1,608,178,786,0.618
LDZA,ESKN,2,1150,43,1193,0.466
LDZA,ESKN,2,1157,69,1226,0.529
LDZA,ESKN,2,1150,176,1326,0.847
LDZA,ESKN,2,1163,327,1490,0.872
LDZA,ESKN,1,608,691,1299,0.477
LDZA,ESKN,1,604,145,749,0.472
LDZA,ESKN,2,1151,115,1266,0.454
LDZA,ESKN,2,1155,448,1603,0.891
LDZA,ESKN,2,1155,315,1470,0.520
LDZA,ESKN,1,608,423,1031,0.685
LDZA,ESKN,2,1150,179,1329,0.793
LDZA,ESKN,1,608,67,675,0.775
LDZA,ESKN,2,1154,130,1284,0.467
LDZA,ESKN,2,1154,53,1207,0.460
LDZA,ESKN,1,604,288,892,0.860
LDZA,ESKN,2,1153,151,1304,0.709
LDZA,ESKN,1,608,718,1326,0.497
LDZA,ESKN,1,608,283,891,0.466
LDZA,ESKN,1,608,526,1134,0.586
LDZA,ESKN,1,608,579,1187,0.549
LDZA,ESKN,1,604,365,969,0.807
LDZA,ESKN,1,604,98,702,0.544
LDZA,ESKN,2,1144,74,1218,0.804
LDZA,ESKN,2,1092,160,1252,0.509
LDZA,ESKN,2,1092,117,1209,0.813
LDZA,ESKN,2,1163,285,1448,0.737
LDZA,ESKN,1,604,328,932,0.866
LDZA,ESKN,2,1144,301,1445,0.828
LDZA,ESKN,1,604,662,1266,0.507
LDZA,ESKN,1,604,289,893,0.812
LDZA,ESKN,2,1166,200,1366,0.947
LDZA,ESKN,1,608,62,670,0.769
LDZA,ESKN,2,1160,379,1539,0.922
LDZA,ESKN,2,1150,108,1258,0.871
LDZA,ESKN,1,608,582,1190,0.637
LDZA,ESKN,2,1163,380,1543,0.879
LDZA,ESKN,2,1267,140,1407,0.777
LDZA,ESKN,2,1166,261,1427,0.822
LDZA,ESKN,1,608,253,861,0.928
LDZA,ESKN,2,1144,249,1393,0.844
LDZA,ESKN,1,608,331,939,0.842
LDZA,ESKN,1,604,13,617,0.816
LDZA,ESKN,1,608,0,608,0.899
LDZA,ESKN,1,608,758,1366,0.757
LDZA,ESKN,2,1163,360,1523,0.792
LDZA,ESKN,2,1161,209,1370,0.758
LDZA,ESKN,1,608,608,1216,0.703
LDZA,ESKN,2,1147,434,1581,0.904
LDZA,ESKN,2,1097,265,1362,0.818
LDZA,ESKN,2,1144,151,1295,0.827
LDZA,ESKN,2,1154,82,1236,0.838
LDZA,ESKN,2,1092,291,1383,0.575
LDZA,ESKN,1,604,252,856,0.754
LDZA,ESKN,1,608,173,781,0.859
LDZA,ESKN,2,1150,196,1346,0.822
LDZA,ESKN,2,1092,283,1375,0.879
LDZA,ESKN,2,1097,317,1414,0.843
LDZA,ESKN,2,1151,389,1540,0.825
LDZA,ESKN,2,1147,103,1250,0.843
LDZA,ESKN,2,1144,47,1191,1.299
LDZA,ESKN,2,1158,145,1303,0.967
LDZA,ESKN,2,1158,189,1347,0.845
LDZA,ESKN,2,1144,231,1375,0.919
LDZA,ESKN,2,1155,208,1363,0.953
LDZA,ESKN,2,1166,274,1440,0.867
LDZA,ESKN,1,604,685,1289,0.818
LDZA,ESKN,2,1154,5,1159,0.874
LDZA,ESKN,2,1154,214,1368,0.592
LDZA,ESKN,1,608,158,766,0.891
LDZA,ESKN,2,1150,183,1333,0.830
LDZA,ESKN,2,1157,330,1487,0.879
LDZA,ESKN,2,1157,241,1398,0.886
LDZA,ESKN,2,1092,98,1190,0.839
LDZA,ESKN,1,608,714,1322,0.882
LDZA,ESKN,2,1154,89,1243,0.882
LDZA,ESKN,1,608,314,922,0.828
LDZA,ESKN,2,1154,77,1231,0.805
LDZA,ESKN,2,1153,136,1289,0.875
LDZA,ESKN,1,608,554,1162,0.738
LDZA,ESKN,2,1092,322,1414,0.849
LDZA,ESKN,1,608,66,674,0.791
LDZA,ESKN,2,1091,408,1499,0.888
LDZA,ESKN,2,1163,342,1505,0.809
LDZA,ESKN,2,1153,286,1439,0.772
LDZA,ESKN,2,1150,230,1380,0.463
LDZA,ESKN,1,604,659,1263,0.609
LDZA,ESKN,1,608,75,683,0.864
LDZA,ESKN,2,1092,252,1344,0.635
LDZA,ESKN,2,1158,282,1440,0.462
LDZA,ESKN,1,604,534,1138,0.442
LDZA,ESKN,2,1155,400,1555,0.440
LDZA,ESKN,2,1144,109,1253,0.963
LDZA,ESKN,1,604,492,1096,0.524
LDZA,ESKN,2,1155,267,1422,0.737
LDZA,ESKN,2,1153,344,1497,0.795
LDZA,ESKN,1,608,592,1200,0.978
LDZA,ESKN,2,1155,210,1365,0.646
LDZA,ESKN,1,608,414,1022,0.516
LDZA,ESKN,2,1151,208,1359,0.602
LDZA,ESKN,2,1144,161,1305,0.401
LDZA,ESKN,1,608,426,1034,0.467
LDZA,ESKN,1,608,285,893,0.486
LDZA,ESKN,1,608,653,1261,0.796
LDZA,ESKN,1,604,712,1316,0.469
LDZA,ESKN,2,1166,152,1318,0.442
LDZA,ESKN,2,1150,92,1242,0.520
LDZA,ESKN,2,1092,292,1384,0.461
LDZA,ESKN,2,1154,74,1228,0.565
LDZA,ESKN,2,1150,261,1411,0.662
LDZA,ESKN,2,1267,149,1416,0.728
LDZA,ESKN,1,608,576,1184,0.501
LDZA,ESKN,2,1150,61,1211,0.837
LDZA,ESKN,2,1267,101,1368,0.462
LDZA,ESKN,1,604,511,1115,0.479
LDZA,ESKN,2,1147,66,1213,0.680
LDZA,ESKN,2,1092,319,1411,0.435
LDZA,ESKN,2,1092,120,1212,0.582
LDZA,ESKN,2,1157,61,1218,0.520
LDZA,ESKN,2,1147,31,1178,0.554
LDZA,ESKN,2,1151,136,1287,0.422
LDZA,ESKN,2,1147,351,1498,0.448
LDZA,ESKN,2,1092,306,1398,0.453
LDZA,ESKN,2,1147,19,1166,0.421
LDZA,ESKN,2,1157,354,1511,0.718
LDZA,ESKN,2,1092,236,1328,0.456
LDZA,ESKN,1,604,191,795,0.567
LDZA,ESKN,1,608,299,907,0.834
LDZA,ESKN,1,604,618,1222,0.476
LDZA,ESKN,2,1153,182,1335,0.454
LDZA,ESKN,2,1092,326,1418,0.482
LDZA,ESKN,2,1151,251,1402,0.827
LDZA,ESKN,2,1158,260,1418,0.454
LDZA,ESKN,1,608,513,1121,0.553
LDZA,ESKN,2,1097,248,1345,0.495
LDZA,ESKN,1,604,611,1215,0.433
LDZA,ESKN,2,1144,112,1256,0.718
LDZA,ESKN,2,1151,234,1385,0.464
LDZA,ESKN,1,604,598,1202,0.593
LDZA,ESKN,1,608,198,806,0.649
LDZA,ESKN,1,608,357,965,0.611
LDZA,ESKN,2,1157,342,1499,0.544
LDZA,ESKN,1,604,631,1235,0.420
LDZA,ESKN,2,1267,131,1398,0.451
LDZA,ESKN,2,1092,345,1437,0.448
LDZA,ESKN,1,608,331,939,0.722
LDZA,ESKN,2,1166,147,1313,0.460
LDZA,ESKN,2,1151,217,1368,0.459
LDZA,ESKN,2,1150,149,1299,0.561
LDZA,ESKN,2,1157,283,1440,0.478
LDZA,ESKN,2,1150,111,1261,0.476
LDZA,ESKN,2,1150,241,1391,0.481
LDZA,ESKN,1,604,336,940,0.435
LDZA,ESKN,2,1151,254,1405,0.612
LDZA,ESKN,2,1150,215,1365,0.701
LDZA,ESKN,1,604,788,1392,0.445
LDZA,ESKN,2,1147,304,1451,0.360
LDZA,ESKN,2,1157,414,1571,0.449
LDZA,ESKN,1,604,500,1104,0.443
LDZA,ESKN,2,1163,364,1527,0.534
LDZA,ESKN,1,604,680,1284,0.593
LDZA,ESKN,1,608,617,1225,0.401
LDZA,ESKN,2,1267,64,1331,0.528
LDZA,ESKN,2,1144,212,1356,0.472
LDZA,ESKN,2,1163,379,1542,0.624
LDZA,ESKN,2,1161,181,1342,0.468
LDZA,ESKN,2,1151,363,1514,0.488
LDZA,ESKN,1,608,606,1214,0.473
LDZA,ESKN,2,1144,165,1309,0.763
LDZA,ESKN,2,1154,120,1274,0.439
LDZA,ESKN,1,608,391,999,0.511
LDZA,ESKN,1,608,311,919,0.485
LDZA,ESKN,2,1155,128,1283,0.531
LDZA,ESKN,2,1144,256,1400,0.531
LDZA,ESKN,1,608,279,887,0.556
LDZA,ESKN,2,1144,171,1315,0.387
LDZA,ESKN,2,1144,128,1272,0.440
LDZA,ESKN,1,608,675,1283,0.440
LDZA,ESKN,2,1154,125,1279,0.686
LDZA,ESKN,1,608,254,862,0.600
LDZA,ESKN,2,1160,276,1436,0.441
LDZA,ESKN,2,1147,120,1267,0.518
LDZA,ESKN,2,1267,48,1315,0.886
LDZA,ESKN,2,1155,355,1510,0.566
LDZA,ESKN,2,1147,194,1341,0.734
LDZA,ESKN,1,608,308,916,0.466
LDZA,ESKN,2,1161,221,1382,0.438
LDZA,ESKN,2,1147,61,1208,0.697
LDZA,ESKN,2,1147,117,1264,0.473
LDZA,ESKN,2,1158,119,1277,0.577
LDZA,ESKN,2,1144,176,1320,0.822
LDZA,ESKN,2,1166,282,1448,0.491
LDZA,ESKN,2,1151,233,1384,0.438
LDZA,ESKN,2,1144,157,1301,0.569
LDZA,ESKN,1,608,279,887,0.774
LDZA,ESKN,1,608,527,1135,0.580
LDZA,ESKN,1,604,79,683,1.065
LDZA,ESKN,2,1092,108,1200,0.452
LDZA,ESKN,2,1157,186,1343,0.856
LDZA,ESKN,2,1163,426,1589,0.802
LDZA,ESKN,1,604,163,767,0.511
LDZA,ESKN,1,604,540,1144,0.728
LDZA,ESKN,2,1158,133,1291,0.568
LDZA,ESKN,1,604,497,1101,0.447
LDZA,ESKN,1,608,698,1306,0.870
LDZA,ESKN,1,604,258,862,0.460
LDZA,ESKN,2,1144,41,1185,0.789
LDZA,ESKN,2,1155,188,1343,0.755
LDZA,ESKN,1,608,594,1202,0.774
LDZA,ESKN,2,1144,149,1293,0.451
LDZA,ESKN,2,1150,96,1246,0.470
LDZA,ESKN,2,1151,175,1326,0.788
LDZA,ESKN,1,608,128,736,0.799
LDZA,ESKN,2,1161,200,1361,0.797
LDZA,ESKN,2,1151,282,1433,0.662
LDZA,ESKN,1,608,411,1019,0.496
LDZA,ESKN,1,604,447,1051,0.584
LDZA,ESKN,1,604,394,998,0.523
LDZA,ESKN,1,604,77,681,0.690
LDZA,ESKN,1,604,237,841,0.443
LDZA,ESKN,2,1158,308,1466,0.481
LDZA,ESKN,1,604,38,642,0.487
LDZA,ESKN,2,1151,240,1391,0.476
LDZA,ESKN,2,1158,141,1299,0.618
LDZA,ESKN,2,1151,147,1298,0.516
LDZA,ESKN,2,1092,286,1378,0.735
LDZA,ESKN,1,608,74,682,0.779
LDZA,ESKN,2,1158,157,1315,0.769
LDZA,ESKN,2,1144,80,1224,0.495
LDZA,ESKN,1,608,387,995,0.451
LDZA,ESKN,1,608,498,1106,0.532
LDZA,ESKN,2,1092,302,1394,0.714
LDZA,ESKN,1,608,368,976,0.464
LDZA,ESKN,2,1092,90,1182,0.669
LDZA,ESKN,1,608,616,1224,0.848
LDZA,ESKN,2,1157,319,1476,0.442
LDZA,ESKN,2,1157,388,1545,0.840
LDZA,ESKN,1,608,696,1304,0.462
LDZA,ESKN,1,604,166,770,0.714
LDZA,ESKN,1,604,110,714,0.705
LDZA,ESKN,2,1151,248,1399,1.003
LDZA,ESKN,2,1144,113,1257,0.446
LDZA,ESKN,2,1092,139,1231,0.445
LDZA,ESKN,1,608,416,1024,0.524
LDZA,ESKN,2,1144,223,1367,0.519
LDZA,ESKN,2,1144,81,1225,0.492
LDZA,ESKN,1,608,420,1028,0.788
LDZA,ESKN,2,1091,442,1533,0.804
LDZA,ESKN,2,1155,339,1494,0.443
LDZA,ESKN,2,1158,268,1426,0.425
LDZA,ESKN,2,1144,40,1184,0.562
LDZA,ESKN,2,1150,86,1236,0.707
LDZA,ESKN,2,1155,265,1420,0.629
LDZA,ESKN,1,604,568,1172,0.453
LDZA,ESKN,2,1091,378,1469,0.694
LDZA,ESKN,2,1150,77,1227,0.515
LDZA,ESKN,1,604,349,953,0.443
LDZA,ESKN,2,1151,231,1382,0.479
LDZA,ESKN,2,1154,119,1273,0.592
LDZA,ESKN,1,608,99,707,0.462
LDZA,ESKN,2,1092,448,1540,0.524
LDZA,ESKN,2,1163,377,1540,0.452
LDZA,ESKN,2,1092,332,1424,0.702
LDZA,ESKN,1,608,367,975,0.720
LDZA,ESKN,2,1157,48,1205,0.433
LDZA,ESKN,2,1267,150,1417,0.622
LDZA,ESKN,2,1093,372,1465,0.581
LDZA,ESKN,1,604,732,1336,0.638
LDZA,ESKN,1,608,54,662,0.737
LDZA,ESKN,1,608,678,1286,0.724
LDZA,ESKN,2,1158,151,1309,0.450
LDZA,ESKN,2,1092,396,1488,0.465
LDZA,ESKN,2,1151,272,1423,0.506
LDZA,ESKN,1,604,412,1016,0.739
LDZA,ESKN,2,1144,184,1328,0.906
LDZA,ESKN,1,604,296,900,0.418
LDZA,ESKN,1,608,429,1037,0.807
LDZA,ESKN,2,1267,201,1468,0.715
LDZA,ESKN,2,1166,268,1434,0.453
LDZA,ESKN,1,604,301,905,0.442
LDZA,ESKN,1,608,347,955,0.489
LDZA,ESKN,2,1092,368,1460,0.648
LDZA,ESKN,1,604,698,1302,0.855
LDZA,ESKN,1,608,32,640,0.448
LDZA,ESKN,1,604,423,1027,0.422
LDZA,ESKN,1,608,573,1181,0.784
LDZA,ESKN,1,608,364,972,0.577
LDZA,ESKN,2,1154,9,1163,0.424
LDZA,ESKN,1,608,491,1099,0.744
LDZA,ESKN,2,1144,269,1413,0.731
LDZA,ESKN,1,604,535,1139,0.650
LDZA,ESKN,1,608,707,1315,0.434
LDZA,ESKN,2,1155,217,1372,0.704
LDZA,ESKN,2,1158,145,1303,0.701
LDZA,ESKN,1,604,341,945,0.585
LDZA,ESKN,2,1154,210,1364,0.427
LDZA,ESKN,2,1155,284,1439,0.451
LDZA,ESKN,2,1147,163,1310,0.858
LDZA,ESKN,2,1157,190,1347,0.712
LDZA,ESKN,2,1154,145,1299,0.440
LDZA,ESKN,1,604,674,1278,0.476
LDZA,ESKN,2,1150,128,1278,0.829
LDZA,ESKN,2,1144,150,1294,0.515
LDZA,ESKN,2,1155,356,1511,0.391
LDZA,ESKN,2,1150,91,1241,0.424
LDZA,ESKN,2,1151,220,1371,0.516
LDZA,ESKN,2,1163,352,1515,0.552
LDZA,ESKN,1,608,147,755,0.443
LDZA,ESKN,2,1155,277,1432,0.447
LDZA,ESKN,2,1150,356,1506,0.552
LDZA,ESKN,2,1163,361,1524,0.522
LDZA,ESKN,2,1154,158,1312,0.527
LDZA,ESKN,2,1092,301,1393,0.537
LDZA,ESKN,1,608,63,671,0.443
LDZA,ESKN,1,604,79,683,0.459
LDZA,ESKN,1,608,223,831,0.471
LDZA,ESKN,2,1161,170,1331,0.450
LDZA,ESKN,2,1155,188,1343,0.525
LDZA,ESKN,2,1166,148,1314,0.588
LDZA,ESKN,1,608,362,970,0.458
LDZA,ESKN,2,1092,203,1295,0.396
LDZA,ESKN,1,608,229,837,0.514
LDZA,ESKN,2,1158,174,1332,0.532
LDZA,ESKN,2,1166,223,1389,0.530
LDZA,ESKN,2,1150,108,1258,0.432
LDZA,ESKN,2,1144,105,1249,0.618
LDZA,ESKN,1,604,148,752,0.460
LDZA,ESKN,2,1147,29,1176,0.452
LDZA,ESKN,2,1158,232,1390,0.567
LDZA,ESKN,2,1161,289,1450,0.534
LDZA,ESKN,2,1267,111,1378,0.525
LDZA,ESKN,2,1147,387,1534,0.580
LDZA,ESKN,2,1157,218,1375,0.332
LDZA,ESKN,2,1157,253,1410,0.826
LDZA,ESKN,2,1092,327,1419,0.463
LDZA,ESKN,2,1092,223,1315,0.426
LDZA,ESKN,2,1144,229,1373,0.465
LDZA,ESKN,2,1150,200,1350,0.454
LDZA,ESKN,1,608,147,755,0.726
LDZA,ESKN,2,1159,373,1532,0.454
LDZA,ESKN,2,1158,198,1356,0.470
LDZA,ESKN,2,1157,276,1433,0.750
LDZA,ESKN,1,608,226,834,0.686
LDZA,ESKN,1,604,378,982,0.427
LDZA,ESKN,2,1147,288,1435,0.709
LDZA,ESKN,1,604,457,1061,0.527
LDZA,ESKN,1,608,202,810,0.599
LDZA,ESKN,1,604,527,1131,0.449
LDZA,ESKN,1,608,731,1339,0.463
LDZA,ESKN,2,1158,157,1315,0.377
LDZA,ESKN,2,1151,278,1429,0.488
LDZA,ESKN,1,604,112,716,0.468
LDZA,ESKN,1,608,448,1056,0.804
LDZA,ESKN,2,1155,260,1415,0.499
LDZA,ESKN,2,1097,266,1363,0.473
LDZA,ESKN,2,1144,200,1344,0.712
LDZA,ESKN,1,608,99,707,0.548
LDZA,ESKN,2,1151,244,1395,0.506
LDZA,ESKN,2,1144,102,1246,0.582
LDZA,ESKN,2,1158,256,1414,0.445
LDZA,ESKN,2,1163,278,1441,0.461
LDZA,ESKN,1,608,63,671,0.823
LDZA,ESKN,2,1091,318,1409,0.782
LDZA,ESKN,1,608,623,1231,0.452
LDZA,ESKN,2,1147,370,1517,0.448
LDZA,ESKN,2,1144,47,1191,0.778
LDZA,ESKN,2,1150,442,1592,0.553
LDZA,ESKN,1,604,236,840,0.470
LDZA,ESKN,2,1154,82,1236,0.505
LDZA,ESKN,1,608,32,640,0.818
LDZA,ESKN,2,1150,126,1276,0.445
LDZA,ESKN,1,608,687,1295,0.818
LDZA,ESKN,1,608,731,1339,0.715
LDZA,ESKN,2,1092,206,1298,0.700
LDZA,ESKN,1,608,657,1265,0.760
