Origin,Destination,N_flights,Flight_time,Wait_time,Total_time
SBBR,UMMS,2,1692,239,1931
SBBR,UMMS,2,1741,261,2002
SBBR,UMMS,2,1695,531,2226
SBBR,UMMS,2,1755,143,1898
SBBR,UMMS,2,1691,146,1837
SBBR,UMMS,1,1212,1024,2236
SBBR,UMMS,1,1200,609,1809
SBBR,UMMS,2,1995,391,2386
SBBR,UMMS,2,1752,575,2327
SBBR,UMMS,2,1755,520,2275
SBBR,UMMS,2,1757,814,2571
SBBR,UMMS,2,1755,626,2381
SBBR,UMMS,2,1868,318,2186
SBBR,UMMS,2,1695,611,2306
SBBR,UMMS,2,1757,481,2238
SBBR,UMMS,2,1692,240,1932
SBBR,UMMS,1,1200,883,2083
SBBR,UMMS,2,1759,242,2001
SBBR,UMMS,2,1758,232,1990
SBBR,UMMS,2,1747,537,2284
SBBR,UMMS,3,2425,237,2662
SBBR,UMMS,1,1200,338,1538
SBBR,UMMS,2,1698,495,2193
SBBR,UMMS,2,1758,368,2126
SBBR,UMMS,2,1747,164,1911
SBBR,UMMS,2,1750,295,2045
SBBR,UMMS,1,1200,886,2086
SBBR,UMMS,1,1212,833,2045
SBBR,UMMS,3,2288,365,2653
SBBR,UMMS,2,1698,103,1801
SBBR,UMMS,2,1749,488,2237
SBBR,UMMS,2,1755,449,2204
SBBR,UMMS,2,1761,586,2347
SBBR,UMMS,1,1212,594,1806
SBBR,UMMS,2,1692,392,2084
SBBR,UMMS,2,1743,179,1922
SBBR,UMMS,2,1762,423,2185
SBBR,UMMS,2,1691,395,2086
SBBR,UMMS,1,1200,384,1584
SBBR,UMMS,1,1212,675,1887
SBBR,UMMS,1,1200,784,1984
SBBR,UMMS,1,1200,878,2078
SBBR,UMMS,2,1756,309,2065
SBBR,UMMS,1,1212,176,1388
SBBR,UMMS,3,2308,363,2671
SBBR,UMMS,1,1212,408,1620
SBBR,UMMS,2,1702,169,1871
SBBR,UMMS,2,1702,256,1958
SBBR,UMMS,1,1200,523,1723
SBBR,UMMS,2,1861,268,2129
SBBR,UMMS,1,1212,653,1865
SBBR,UMMS,1,1212,494,1706
SBBR,UMMS,1,1200,297,1497
SBBR,UMMS,3,2307,189,2496
SBBR,UMMS,1,1212,597,1809
SBBR,UMMS,2,1987,841,2828
SBBR,UMMS,2,1755,322,2077
SBBR,UMMS,2,1762,345,2107
SBBR,UMMS,2,1749,186,1935
SBBR,UMMS,1,1200,135,1335
SBBR,UMMS,1,1212,623,1835
SBBR,UMMS,1,1200,227,1427
SBBR,UMMS,2,1752,683,2435
SBBR,UMMS,2,1875,422,2297
SBBR,UMMS,2,1695,277,1972
SBBR,UMMS,1,1212,435,1647
SBBR,UMMS,2,1692,194,1886
SBBR,UMMS,1,1212,129,1341
SBBR,UMMS,2,1861,235,2096
SBBR,UMMS,2,1759,159,1918
SBBR,UMMS,2,1747,541,2288
SBBR,UMMS,2,1748,366,2114
SBBR,UMMS,1,1212,395,1607
SBBR,UMMS,1,1200,336,1536
SBBR,UMMS,2,1747,574,2321
SBBR,UMMS,1,1212,289,1501
SBBR,UMMS,1,1212,872,2084
SBBR,UMMS,2,1746,600,2346
SBBR,UMMS,1,1200,232,1432
SBBR,UMMS,2,1743,454,2197
SBBR,UMMS,2,1755,360,2115
SBBR,UMMS,1,1200,333,1533
SBBR,UMMS,2,1692,606,2298
SBBR,UMMS,2,1748,644,2392
SBBR,UMMS,1,1212,1104,2316
SBBR,UMMS,2,1755,224,1979
SBBR,UMMS,2,1750,640,2390
SBBR,UMMS,2,1754,290,2044
SBBR,UMMS,2,1702,310,2012
SBBR,UMMS,2,1696,687,2383
SBBR,UMMS,1,1212,107,1319
SBBR,UMMS,1,1212,305,1517
SBBR,UMMS,1,1200,611,1811
SBBR,UMMS,2,1751,900,2651
SBBR,UMMS,2,1750,241,1991
SBBR,UMMS,2,1692,164,1856
SBBR,UMMS,1,1212,750,1962
SBBR,UMMS,2,1755,233,1988
SBBR,UMMS,2,1750,245,1995
SBBR,UMMS,2,1747,458,2205
SBBR,UMMS,1,1200,265,1465
SBBR,UMMS,2,1749,191,1940
SBBR,UMMS,1,1212,243,1455
SBBR,UMMS,2,1749,358,2107
SBBR,UMMS,2,1761,569,2330
SBBR,UMMS,1,1200,132,1332
SBBR,UMMS,1,1212,341,1553
SBBR,UMMS,1,1200,658,1858
SBBR,UMMS,2,1755,441,2196
SBBR,UMMS,2,1691,127,1818
SBBR,UMMS,1,1200,166,1366
SBBR,UMMS,1,1200,87,1287
SBBR,UMMS,1,1212,354,1566
SBBR,UMMS,2,1695,499,2194
SBBR,UMMS,3,2287,152,2439
SBBR,UMMS,2,1695,248,1943
SBBR,UMMS,2,1695,645,2340
SBBR,UMMS,2,1754,531,2285
SBBR,UMMS,1,1212,847,2059
SBBR,UMMS,2,1755,350,2105
SBBR,UMMS,2,1696,512,2208
SBBR,UMMS,1,1212,406,1618
SBBR,UMMS,2,1695,177,1872
SBBR,UMMS,2,1758,435,2193
SBBR,UMMS,2,1819,439,2258
SBBR,UMMS,1,1200,356,1556
SBBR,UMMS,2,1750,442,2192
SBBR,UMMS,2,1752,338,2090
SBBR,UMMS,1,1200,686,1886
SBBR,UMMS,2,1691,216,1907
SBBR,UMMS,2,1698,356,2054
SBBR,UMMS,2,1759,532,2291
SBBR,UMMS,2,1749,196,1945
SBBR,UMMS,2,1755,724,2479
SBBR,UMMS,2,1755,619,2374
SBBR,UMMS,1,1212,316,1528
SBBR,UMMS,1,1200,1027,2227
SBBR,UMMS,1,1200,724,1924
SBBR,UMMS,1,1212,458,1670
SBBR,UMMS,2,1698,183,1881
SBBR,UMMS,2,1762,610,2372
SBBR,UMMS,2,1868,294,2162
SBBR,UMMS,1,1212,323,1535
SBBR,UMMS,2,1754,721,2475
SBBR,UMMS,1,1200,729,1929
SBBR,UMMS,1,1200,921,2121
SBBR,UMMS,1,1212,881,2093
SBBR,UMMS,1,1212,72,1284
SBBR,UMMS,2,1748,468,2216
SBBR,UMMS,2,1748,244,1992
SBBR,UMMS,2,1747,602,2349
SBBR,UMMS,2,1750,514,2264
SBBR,UMMS,2,1759,668,2427
SBBR,UMMS,1,1212,0,1212
SBBR,UMMS,2,1755,382,2137
SBBR,UMMS,2,1758,471,2229
SBBR,UMMS,2,1747,286,2033
SBBR,UMMS,1,1200,609,1809
SBBR,UMMS,2,1692,336,2028
SBBR,UMMS,2,1759,227,1986
SBBR,UMMS,2,1698,512,2210
SBBR,UMMS,2,1695,425,2120
SBBR,UMMS,2,1756,666,2422
SBBR,UMMS,2,1695,410,2105
SBBR,UMMS,2,1746,701,2447
SBBR,UMMS,2,1755,591,2346
SBBR,UMMS,1,1200,118,1318
SBBR,UMMS,2,1692,148,1840
SBBR,UMMS,2,1762,231,1993
SBBR,UMMS,2,1746,399,2145
SBBR,UMMS,1,1212,989,2201
SBBR,UMMS,1,1212,551,1763
SBBR,UMMS,1,1212,1164,2376
SBBR,UMMS,2,1755,406,2161
SBBR,UMMS,2,1751,718,2469
SBBR,UMMS,1,1200,184,1384
SBBR,UMMS,1,1212,124,1336
SBBR,UMMS,1,1200,105,1305
SBBR,UMMS,2,1691,392,2083
SBBR,UMMS,1,1212,865,2077
SBBR,UMMS,2,1755,248,2003
SBBR,UMMS,2,1746,218,1964
SBBR,UMMS,1,1200,171,1371
SBBR,UMMS,1,1212,235,1447
SBBR,UMMS,1,1200,358,1558
SBBR,UMMS,2,1744,317,2061
SBBR,UMMS,1,1200,504,1704
SBBR,UMMS,1,1212,337,1549
SBBR,UMMS,1,1212,151,1363
SBBR,UMMS,1,1212,740,1952
SBBR,UMMS,2,1751,469,2220
SBBR,UMMS,2,1875,157,2032
SBBR,UMMS,1,1200,307,1507
SBBR,UMMS,2,1752,479,2231
SBBR,UMMS,1,1200,644,1844
SBBR,UMMS,2,1702,156,1858
SBBR,UMMS,2,1755,650,2405
SBBR,UMMS,2,1753,795,2548
SBBR,UMMS,2,1698,180,1878
SBBR,UMMS,2,1762,413,2175
SBBR,UMMS,1,1212,287,1499
SBBR,UMMS,2,1751,713,2464
SBBR,UMMS,1,1200,438,1638
SBBR,UMMS,1,1200,354,1554
SBBR,UMMS,2,1743,127,1870
SBBR,UMMS,1,1212,184,1396
SBBR,UMMS,2,1868,468,2336
SBBR,UMMS,2,1982,612,2594
SBBR,UMMS,2,1752,1136,2888
SBBR,UMMS,2,1747,266,2013
SBBR,UMMS,2,1755,347,2102
SBBR,UMMS,2,1750,311,2061
SBBR,UMMS,1,1212,58,1270
SBBR,UMMS,1,1212,408,1620
SBBR,UMMS,2,1748,335,2083
SBBR,UMMS,2,1695,976,2671
SBBR,UMMS,1,1200,930,2130
SBBR,UMMS,2,1766,426,2192
SBBR,UMMS,2,1752,610,2362
SBBR,UMMS,1,1200,30,1230
SBBR,UMMS,2,1748,438,2186
SBBR,UMMS,2,1743,275,2018
SBBR,UMMS,1,1200,910,2110
SBBR,UMMS,2,1696,871,2567
SBBR,UMMS,2,1875,134,2009
SBBR,UMMS,2,1695,252,1947
SBBR,UMMS,1,1200,690,1890
SBBR,UMMS,1,1212,621,1833
SBBR,UMMS,1,1200,197,1397
SBBR,UMMS,2,1744,540,2284
SBBR,UMMS,1,1212,723,1935
SBBR,UMMS,2,1762,442,2204
SBBR,UMMS,2,1698,321,2019
SBBR,UMMS,1,1200,611,1811
SBBR,UMMS,1,1212,604,1816
SBBR,UMMS,3,2302,160,2462
SBBR,UMMS,1,1200,449,1649
SBBR,UMMS,2,1755,165,1920
SBBR,UMMS,2,1756,599,2355
SBBR,UMMS,1,1212,312,1524
SBBR,UMMS,2,1695,252,1947
SBBR,UMMS,2,1741,215,1956
SBBR,UMMS,2,1755,328,2083
SBBR,UMMS,2,1758,629,2387
SBBR,UMMS,2,1759,381,2140
SBBR,UMMS,1,1212,48,1260
SBBR,UMMS,2,1741,241,1982
SBBR,UMMS,2,1752,636,2388
SBBR,UMMS,1,1200,237,1437
SBBR,UMMS,1,1200,545,1745
SBBR,UMMS,1,1212,617,1829
SBBR,UMMS,2,1749,639,2388
SBBR,UMMS,2,1760,323,2083
SBBR,UMMS,1,1212,48,1260
SBBR,UMMS,2,1695,178,1873
SBBR,UMMS,2,1744,732,2476
SBBR,UMMS,1,1200,649,1849
SBBR,UMMS,2,1695,157,1852
SBBR,UMMS,1,1212,836,2048
SBBR,UMMS,1,1212,724,1936
SBBR,UMMS,1,1200,171,1371
SBBR,UMMS,1,1212,366,1578
SBBR,UMMS,1,1212,716,1928
SBBR,UMMS,2,1759,576,2335
SBBR,UMMS,2,1746,704,2450
SBBR,UMMS,1,1212,385,1597
SBBR,UMMS,1,1200,11,1211
SBBR,UMMS,3,2305,476,2781
SBBR,UMMS,2,1757,492,2249
SBBR,UMMS,2,1692,942,2634
SBBR,UMMS,2,1754,736,2490
SBBR,UMMS,2,1747,748,2495
SBBR,UMMS,2,1755,515,2270
SBBR,UMMS,2,1762,740,2502
SBBR,UMMS,2,1756,148,1904
SBBR,UMMS,2,1698,264,1962
SBBR,UMMS,1,1212,583,1795
SBBR,UMMS,1,1212,172,1384
SBBR,UMMS,1,1212,1393,2605
SBBR,UMMS,2,1696,982,2678
SBBR,UMMS,1,1212,412,1624
SBBR,UMMS,1,1200,844,2044
SBBR,UMMS,2,1692,132,1824
SBBR,UMMS,1,1200,656,1856
SBBR,UMMS,2,1754,544,2298
SBBR,UMMS,1,1212,117,1329
SBBR,UMMS,2,1702,455,2157
SBBR,UMMS,2,1755,365,2120
SBBR,UMMS,2,1747,81,1828
SBBR,UMMS,1,1212,120,1332
SBBR,UMMS,1,1212,368,1580
SBBR,UMMS,1,1212,679,1891
SBBR,UMMS,1,1200,936,2136
SBBR,UMMS,1,1212,362,1574
SBBR,UMMS,2,1707,486,2193
SBBR,UMMS,1,1200,447,1647
SBBR,UMMS,2,1875,270,2145
SBBR,UMMS,2,1743,485,2228
SBBR,UMMS,1,1200,522,1722
SBBR,UMMS,2,1698,462,2160
SBBR,UMMS,2,1749,316,2065
SBBR,UMMS,2,1746,175,1921
SBBR,UMMS,3,2249,332,2581
SBBR,UMMS,2,1696,753,2449
SBBR,UMMS,1,1212,717,1929
SBBR,UMMS,2,1752,512,2264
SBBR,UMMS,1,1212,76,1288
SBBR,UMMS,2,1754,624,2378
SBBR,UMMS,1,1212,336,1548
SBBR,UMMS,2,1759,173,1932
SBBR,UMMS,1,1200,573,1773
SBBR,UMMS,2,1747,140,1887
SBBR,UMMS,2,1695,312,2007
SBBR,UMMS,1,1212,39,1251
SBBR,UMMS,2,1868,309,2177
SBBR,UMMS,1,1212,76,1288
SBBR,UMMS,2,1753,548,2301
SBBR,UMMS,2,1695,477,2172
SBBR,UMMS,2,1755,358,2113
SBBR,UMMS,2,1755,418,2173
SBBR,UMMS,1,1200,944,2144
SBBR,UMMS,2,1691,399,2090
SBBR,UMMS,2,1762,430,2192
SBBR,UMMS,2,1875,85,1960
SBBR,UMMS,2,1759,182,1941
SBBR,UMMS,1,1212,696,1908
SBBR,UMMS,1,1212,586,1798
SBBR,UMMS,2,1755,534,2289
SBBR,UMMS,2,1762,320,2082
SBBR,UMMS,2,1754,594,2348
SBBR,UMMS,2,1754,422,2176
SBBR,UMMS,2,1751,673,2424
SBBR,UMMS,2,1751,833,2584
SBBR,UMMS,2,1761,599,2360
SBBR,UMMS,2,1749,254,2003
SBBR,UMMS,2,1757,735,2492
SBBR,UMMS,2,1747,110,1857
SBBR,UMMS,2,1757,685,2442
SBBR,UMMS,2,1755,857,2612
SBBR,UMMS,1,1212,1161,2373
SBBR,UMMS,1,1212,597,1809
SBBR,UMMS,2,1749,589,2338
SBBR,UMMS,1,1200,161,1361
SBBR,UMMS,2,1695,231,1926
SBBR,UMMS,2,1759,144,1903
SBBR,UMMS,2,1695,365,2060
SBBR,UMMS,2,1756,209,1965
SBBR,UMMS,2,1754,514,2268
SBBR,UMMS,2,1875,273,2148
SBBR,UMMS,1,1212,701,1913
SBBR,UMMS,2,1758,477,2235
SBBR,UMMS,2,1757,490,2247
SBBR,UMMS,1,1200,551,1751
SBBR,UMMS,1,1212,78,1290
SBBR,UMMS,1,1212,597,1809
SBBR,UMMS,1,1212,69,1281
SBBR,UMMS,1,1200,290,1490
SBBR,UMMS,1,1200,749,1949
SBBR,UMMS,2,1692,143,1835
SBBR,UMMS,1,1212,484,1696
SBBR,UMMS,1,1200,158,1358
SBBR,UMMS,1,1200,745,1945
SBBR,UMMS,1,1212,68,1280
SBBR,UMMS,1,1212,533,1745
SBBR,UMMS,2,1766,162,1928
SBBR,UMMS,1,1212,190,1402
SBBR,UMMS,2,1762,370,2132
SBBR,UMMS,1,1212,211,1423
SBBR,UMMS,2,1755,552,2307
SBBR,UMMS,1,1200,308,1508
SBBR,UMMS,2,1755,432,2187
SBBR,UMMS,1,1200,712,1912
SBBR,UMMS,2,1759,261,2020
SBBR,UMMS,1,1212,176,1388
SBBR,UMMS,1,1200,115,1315
SBBR,UMMS,2,1755,660,2415
SBBR,UMMS,2,1746,691,2437
SBBR,UMMS,2,1755,306,2061
SBBR,UMMS,1,1200,434,1634
SBBR,UMMS,1,1200,124,1324
SBBR,UMMS,2,1749,587,2336
SBBR,UMMS,2,1752,502,2254
SBBR,UMMS,2,1747,554,2301
SBBR,UMMS,2,1755,585,2340
SBBR,UMMS,1,1200,698,1898
SBBR,UMMS,2,1748,815,2563
SBBR,UMMS,1,1212,431,1643
SBBR,UMMS,1,1212,750,1962
SBBR,UMMS,2,1743,207,1950
SBBR,UMMS,1,1200,52,1252
SBBR,UMMS,1,1212,668,1880
SBBR,UMMS,1,1200,756,1956
SBBR,UMMS,1,1200,296,1496
SBBR,UMMS,1,1212,267,1479
SBBR,UMMS,1,1212,410,1622
SBBR,UMMS,1,1200,377,1577
SBBR,UMMS,1,1200,276,1476
SBBR,UMMS,2,1753,768,2521
SBBR,UMMS,2,1702,290,1992
SBBR,UMMS,1,1200,491,1691
SBBR,UMMS,1,1200,339,1539
SBBR,UMMS,1,1200,452,1652
SBBR,UMMS,1,1212,252,1464
SBBR,UMMS,1,1200,237,1437
SBBR,UMMS,2,1766,202,1968
SBBR,UMMS,2,1762,225,1987
SBBR,UMMS,2,1861,702,2563
SBBR,UMMS,3,2197,540,2737
SBBR,UMMS,1,1200,637,1837
SBBR,UMMS,2,1743,207,1950
SBBR,UMMS,2,1755,401,2156
SBBR,UMMS,1,1200,363,1563
SBBR,UMMS,1,1200,1034,2234
SBBR,UMMS,2,1698,480,2178
SBBR,UMMS,1,1200,715,1915
SBBR,UMMS,2,1695,257,1952
SBBR,UMMS,1,1212,228,1440
SBBR,UMMS,2,1695,522,2217
SBBR,UMMS,2,1696,632,2328
SBBR,UMMS,1,1212,586,1798
SBBR,UMMS,1,1200,36,1236
SBBR,UMMS,2,1753,747,2500
SBBR,UMMS,2,1750,361,2111
SBBR,UMMS,2,1755,714,2469
SBBR,UMMS,1,1200,503,1703
SBBR,UMMS,2,1761,479,2240
SBBR,UMMS,2,1695,344,2039
SBBR,UMMS,2,1692,542,2234
SBBR,UMMS,1,1200,882,2082
SBBR,UMMS,1,1200,74,1274
SBBR,UMMS,1,1200,620,1820
SBBR,UMMS,2,1764,754,2518
SBBR,UMMS,2,1758,440,2198
SBBR,UMMS,2,1766,220,1986
SBBR,UMMS,2,1695,242,1937
SBBR,UMMS,2,1743,603,2346
SBBR,UMMS,2,1755,216,1971
SBBR,UMMS,1,1212,696,1908
SBBR,UMMS,1,1200,327,1527
SBBR,UMMS,2,1747,414,2161
SBBR,UMMS,1,1212,622,1834
SBBR,UMMS,1,1212,375,1587
SBBR,UMMS,1,1200,716,1916
SBBR,UMMS,2,1692,571,2263
SBBR,UMMS,2,1741,506,2247
SBBR,UMMS,2,1761,579,2340
SBBR,UMMS,2,1747,44,1791
SBBR,UMMS,2,1746,554,2300
SBBR,UMMS,1,1200,144,1344
SBBR,UMMS,2,1695,193,1888
SBBR,UMMS,1,1212,218,1430
SBBR,UMMS,2,1755,365,2120
SBBR,UMMS,2,1754,544,2298
SBBR,UMMS,2,1752,392,2144
SBBR,UMMS,2,1752,594,2346
SBBR,UMMS,1,1212,929,2141
SBBR,UMMS,2,1868,326,2194
SBBR,UMMS,2,1755,587,2342
SBBR,UMMS,1,1200,768,1968
SBBR,UMMS,2,1698,576,2274
SBBR,UMMS,2,1752,432,2184
SBBR,UMMS,2,1756,333,2089
SBBR,UMMS,3,2235,501,2736
SBBR,UMMS,2,1762,530,2292
SBBR,UMMS,2,1875,553,2428
SBBR,UMMS,1,1212,56,1268
SBBR,UMMS,2,1691,488,2179
SBBR,UMMS,2,1754,445,2199
SBBR,UMMS,2,1748,486,2234
SBBR,UMMS,2,1762,451,2213
SBBR,UMMS,2,1692,267,1959
SBBR,UMMS,2,1755,428,2183
SBBR,UMMS,2,1747,426,2173
SBBR,UMMS,2,1875,171,2046
SBBR,UMMS,2,1702,207,1909
SBBR,UMMS,2,1746,936,2682
SBBR,UMMS,1,1200,851,2051
SBBR,UMMS,1,1200,450,1650
SBBR,UMMS,2,1751,857,2608
SBBR,UMMS,2,1757,472,2229
SBBR,UMMS,2,1698,672,2370
SBBR,UMMS,2,1698,667,2365
SBBR,UMMS,1,1200,680,1880
SBBR,UMMS,1,1200,200,1400
SBBR,UMMS,2,1698,84,1782
SBBR,UMMS,2,1752,234,1986
SBBR,UMMS,2,1750,302,2052
SBBR,UMMS,2,1749,639,2388
SBBR,UMMS,2,1987,668,2655
SBBR,UMMS,2,1695,429,2124
SBBR,UMMS,1,1200,454,1654
SBBR,UMMS,2,1698,199,1897
SBBR,UMMS,2,1749,278,2027
SBBR,UMMS,2,1698,271,1969
SBBR,UMMS,2,1760,458,2218
SBBR,UMMS,1,1212,577,1789
SBBR,UMMS,2,1698,426,2124
SBBR,UMMS,2,1752,578,2330
SBBR,UMMS,2,1698,180,1878
SBBR,UMMS,2,1755,498,2253
SBBR,UMMS,2,1749,475,2224
SBBR,UMMS,1,1212,251,1463
SBBR,UMMS,2,1744,528,2272
SBBR,UMMS,1,1212,515,1727
SBBR,UMMS,2,1691,140,1831
SBBR,UMMS,2,1691,119,1810
SBBR,UMMS,2,1692,355,2047
SBBR,UMMS,1,1200,675,1875
SBBR,UMMS,1,1212,182,1394
SBBR,UMMS,2,1747,384,2131
SBBR,UMMS,1,1200,816,2016
SBBR,UMMS,2,1755,456,2211
SBBR,UMMS,1,1212,385,1597
SBBR,UMMS,2,1766,282,2048
SBBR,UMMS,1,1200,646,1846
SBBR,UMMS,2,1875,198,2073
SBBR,UMMS,1,1200,1151,2351
SBBR,UMMS,2,1755,567,2322
SBBR,UMMS,2,1819,483,2302
SBBR,UMMS,1,1212,241,1453
SBBR,UMMS,2,1755,297,2052
SBBR,UMMS,2,1754,376,2130
SBBR,UMMS,2,1755,513,2268
SBBR,UMMS,2,1756,257,2013
SBBR,UMMS,2,1756,596,2352
SBBR,UMMS,2,1698,289,1987
SBBR,UMMS,2,1698,122,1820
SBBR,UMMS,2,1748,220,1968
SBBR,UMMS,2,1746,228,1974
SBBR,UMMS,2,1702,440,2142
SBBR,UMMS,1,1212,336,1548
SBBR,UMMS,2,1695,397,2092
SBBR,UMMS,1,1212,806,2018
SBBR,UMMS,1,1200,893,2093
SBBR,UMMS,2,1755,370,2125
SBBR,UMMS,2,1756,328,2084
SBBR,UMMS,2,1755,508,2263
SBBR,UMMS,2,1751,412,2163
SBBR,UMMS,2,1759,354,2113
SBBR,UMMS,1,1200,658,1858
SBBR,UMMS,2,1758,621,2379
SBBR,UMMS,2,1749,168,1917
SBBR,UMMS,3,2248,606,2854
SBBR,UMMS,1,1212,260,1472
SBBR,UMMS,2,1760,343,2103
SBBR,UMMS,1,1200,196,1396
SBBR,UMMS,2,1760,707,2467
SBBR,UMMS,2,1752,435,2187
SBBR,UMMS,1,1200,166,1366
SBBR,UMMS,2,1748,309,2057
SBBR,UMMS,2,1861,365,2226
SBBR,UMMS,2,1754,552,2306
SBBR,UMMS,2,1695,298,1993
SBBR,UMMS,2,1748,650,2398
SBBR,UMMS,1,1212,178,1390
SBBR,UMMS,2,1758,501,2259
SBBR,UMMS,1,1212,226,1438
SBBR,UMMS,2,1758,385,2143
SBBR,UMMS,2,1749,378,2127
SBBR,UMMS,2,1758,536,2294
SBBR,UMMS,1,1212,448,1660
SBBR,UMMS,2,1698,610,2308
SBBR,UMMS,2,1754,423,2177
SBBR,UMMS,2,1750,246,1996
SBBR,UMMS,2,1746,290,2036
SBBR,UMMS,2,1752,513,2265
SBBR,UMMS,1,1200,107,1307
SBBR,UMMS,2,1756,362,2118
SBBR,UMMS,2,1695,338,2033
SBBR,UMMS,1,1212,796,2008
SBBR,UMMS,2,1755,547,2302
SBBR,UMMS,2,1752,289,2041
SBBR,UMMS,2,1749,573,2322
SBBR,UMMS,1,1212,593,1805
SBBR,UMMS,1,1212,934,2146
SBBR,UMMS,2,1758,607,2365
SBBR,UMMS,1,1212,454,1666
SBBR,UMMS,2,1744,749,2493
SBBR,UMMS,1,1212,496,1708
SBBR,UMMS,2,1749,361,2110
SBBR,UMMS,2,1702,297,1999
SBBR,UMMS,2,1744,830,2574
SBBR,UMMS,2,1748,153,1901
SBBR,UMMS,1,1212,528,1740
SBBR,UMMS,3,2307,465,2772
SBBR,UMMS,1,1200,595,1795
SBBR,UMMS,2,1743,146,1889
SBBR,UMMS,2,1875,473,2348
SBBR,UMMS,2,1749,202,1951
SBBR,UMMS,2,1750,396,2146
SBBR,UMMS,2,1696,627,2323
SBBR,UMMS,2,1748,114,1862
SBBR,UMMS,2,1755,190,1945
SBBR,UMMS,2,1758,678,2436
SBBR,UMMS,2,1755,582,2337
SBBR,UMMS,1,1200,598,1798
SBBR,UMMS,1,1212,614,1826
SBBR,UMMS,1,1200,519,1719
SBBR,UMMS,1,1212,958,2170
SBBR,UMMS,2,1756,221,1977
SBBR,UMMS,2,1691,146,1837
SBBR,UMMS,2,1750,470,2220
SBBR,UMMS,2,1691,693,2384
SBBR,UMMS,2,1759,236,1995
SBBR,UMMS,2,1759,559,2318
SBBR,UMMS,2,1746,319,2065
SBBR,UMMS,2,1755,277,2032
SBBR,UMMS,3,2411,423,2834
SBBR,UMMS,1,1200,255,1455
SBBR,UMMS,1,1200,677,1877
SBBR,UMMS,2,1743,292,2035
SBBR,UMMS,2,1746,330,2076
SBBR,UMMS,1,1212,521,1733
SBBR,UMMS,2,1762,250,2012
SBBR,UMMS,2,1747,677,2424
SBBR,UMMS,2,1748,759,2507
SBBR,UMMS,2,1747,206,1953
SBBR,UMMS,1,1200,886,2086
SBBR,UMMS,2,1747,233,1980
SBBR,UMMS,2,1691,456,2147
SBBR,UMMS,1,1200,313,1513
SBBR,UMMS,1,1200,642,1842
SBBR,UMMS,1,1200,866,2066
SBBR,UMMS,2,1751,594,2345
SBBR,UMMS,1,1212,307,1519
SBBR,UMMS,1,1212,356,1568
SBBR,UMMS,2,1759,180,1939
SBBR,UMMS,1,1200,967,2167
SBBR,UMMS,1,1212,566,1778
SBBR,UMMS,2,1751,701,2452
SBBR,UMMS,1,1200,248,1448
SBBR,UMMS,2,1755,485,2240
SBBR,UMMS,2,1746,463,2209
SBBR,UMMS,2,1755,426,2181
SBBR,UMMS,2,1754,266,2020
SBBR,UMMS,1,1212,217,1429
SBBR,UMMS,2,1875,185,2060
SBBR,UMMS,1,1212,339,1551
SBBR,UMMS,2,1759,544,2303
SBBR,UMMS,2,1691,366,2057
SBBR,UMMS,1,1212,127,1339
SBBR,UMMS,1,1200,20,1220
SBBR,UMMS,2,1758,559,2317
SBBR,UMMS,1,1212,517,1729
SBBR,UMMS,1,1212,585,1797
SBBR,UMMS,2,1749,374,2123
SBBR,UMMS,2,1755,379,2134
SBBR,UMMS,2,1747,144,1891
SBBR,UMMS,2,1757,477,2234
SBBR,UMMS,2,1692,365,2057
SBBR,UMMS,3,2253,531,2784
SBBR,UMMS,1,1212,1060,2272
SBBR,UMMS,2,1752,468,2220
SBBR,UMMS,2,1766,385,2151
SBBR,UMMS,2,1755,407,2162
SBBR,UMMS,1,1212,665,1877
SBBR,UMMS,2,1868,274,2142
SBBR,UMMS,2,1764,559,2323
SBBR,UMMS,1,1200,763,1963
SBBR,UMMS,2,1743,422,2165
SBBR,UMMS,2,1819,464,2283
SBBR,UMMS,1,1200,115,1315
SBBR,UMMS,2,1759,589,2348
SBBR,UMMS,2,1761,695,2456
SBBR,UMMS,1,1212,615,1827
SBBR,UMMS,2,1766,391,2157
SBBR,UMMS,1,1212,482,1694
SBBR,UMMS,2,1695,440,2135
SBBR,UMMS,1,1212,712,1924
SBBR,UMMS,2,1741,502,2243
SBBR,UMMS,2,1761,661,2422
SBBR,UMMS,1,1212,553,1765
SBBR,UMMS,2,1751,994,2745
SBBR,UMMS,1,1212,664,1876
SBBR,UMMS,2,1758,451,2209
SBBR,UMMS,1,1200,431,1631
SBBR,UMMS,2,1698,194,1892
SBBR,UMMS,2,1749,553,2302
SBBR,UMMS,2,1698,399,2097
SBBR,UMMS,2,1756,408,2164
SBBR,UMMS,2,1755,283,2038
SBBR,UMMS,1,1212,534,1746
SBBR,UMMS,2,1695,296,1991
SBBR,UMMS,1,1212,318,1530
SBBR,UMMS,2,1751,586,2337
SBBR,UMMS,2,1762,674,2436
SBBR,UMMS,2,1757,542,2299
SBBR,UMMS,2,1747,314,2061
SBBR,UMMS,2,1744,643,2387
SBBR,UMMS,2,1754,302,2056
SBBR,UMMS,2,1755,530,2285
SBBR,UMMS,1,1212,338,1550
SBBR,UMMS,2,1749,459,2208
SBBR,UMMS,1,1212,58,1270
SBBR,UMMS,2,1743,467,2210
SBBR,UMMS,2,1762,222,1984
SBBR,UMMS,1,1212,707,1919
SBBR,UMMS,2,1744,797,2541
SBBR,UMMS,1,1212,246,1458
SBBR,UMMS,2,1752,645,2397
SBBR,UMMS,2,1755,277,2032
SBBR,UMMS,1,1200,752,1952
SBBR,UMMS,1,1212,283,1495
SBBR,UMMS,1,1200,838,2038
SBBR,UMMS,1,1212,1082,2294
SBBR,UMMS,2,1692,432,2124
SBBR,UMMS,1,1200,358,1558
SBBR,UMMS,2,1987,619,2606
SBBR,UMMS,1,1200,211,1411
SBBR,UMMS,2,1755,317,2072
SBBR,UMMS,2,1698,186,1884
SBBR,UMMS,1,1200,383,1583
SBBR,UMMS,2,1755,157,1912
SBBR,UMMS,1,1212,159,1371
SBBR,UMMS,2,1761,616,2377
SBBR,UMMS,1,1200,196,1396
SBBR,UMMS,2,1756,438,2194
SBBR,UMMS,1,1200,361,1561
SBBR,UMMS,1,1212,575,1787
SBBR,UMMS,2,1762,437,2199
SBBR,UMMS,2,1744,582,2326
SBBR,UMMS,1,1212,84,1296
SBBR,UMMS,2,1757,508,2265
SBBR,UMMS,2,1750,243,1993
SBBR,UMMS,2,1744,571,2315
SBBR,UMMS,2,1748,764,2512
SBBR,UMMS,1,1200,1054,2254
SBBR,UMMS,1,1200,652,1852
SBBR,UMMS,1,1200,38,1238
SBBR,UMMS,1,1200,98,1298
SBBR,UMMS,1,1212,650,1862
SBBR,UMMS,2,1747,432,2179
SBBR,UMMS,1,1212,369,1581
SBBR,UMMS,2,1752,286,2038
SBBR,UMMS,2,1759,193,1952
SBBR,UMMS,2,1691,351,2042
SBBR,UMMS,2,1751,472,2223
SBBR,UMMS,2,1760,319,2079
SBBR,UMMS,2,1692,406,2098
SBBR,UMMS,2,1861,550,2411
SBBR,UMMS,2,1766,408,2174
SBBR,UMMS,2,1755,267,2022
SBBR,UMMS,2,1746,1258,3004
SBBR,UMMS,1,1200,54,1254
SBBR,UMMS,2,1755,662,2417
SBBR,UMMS,2,1746,956,2702
SBBR,UMMS,2,1758,572,2330
SBBR,UMMS,1,1200,314,1514
SBBR,UMMS,2,1875,187,2062
SBBR,UMMS,2,1746,692,2438
SBBR,UMMS,1,1212,213,1425
SBBR,UMMS,2,1766,357,2123
SBBR,UMMS,2,1702,296,1998
SBBR,UMMS,2,1999,395,2394
SBBR,UMMS,1,1200,598,1798
SBBR,UMMS,2,1695,422,2117
SBBR,UMMS,2,1746,480,2226
SBBR,UMMS,1,1200,230,1430
SBBR,UMMS,2,1756,476,2232
SBBR,UMMS,1,1212,322,1534
SBBR,UMMS,1,1200,1081,2281
SBBR,UMMS,2,1702,466,2168
SBBR,UMMS,2,1762,467,2229
SBBR,UMMS,1,1200,127,1327
SBBR,UMMS,2,1758,451,2209
SBBR,UMMS,2,1702,500,2202
SBBR,UMMS,2,1752,138,1890
SBBR,UMMS,2,1697,719,2416
SBBR,UMMS,1,1212,245,1457
SBBR,UMMS,2,1762,896,2658
SBBR,UMMS,1,1200,575,1775
SBBR,UMMS,1,1212,407,1619
SBBR,UMMS,2,1749,619,2368
SBBR,UMMS,1,1212,351,1563
SBBR,UMMS,1,1212,668,1880
SBBR,UMMS,2,1755,175,1930
SBBR,UMMS,1,1212,423,1635
SBBR,UMMS,2,1744,574,2318
SBBR,UMMS,2,1695,186,1881
SBBR,UMMS,2,1746,631,2377
SBBR,UMMS,1,1200,446,1646
SBBR,UMMS,1,1200,758,1958
SBBR,UMMS,1,1200,344,1544
SBBR,UMMS,1,1212,59,1271
SBBR,UMMS,1,1200,793,1993
SBBR,UMMS,2,1756,398,2154
SBBR,UMMS,1,1200,112,1312
SBBR,UMMS,1,1200,715,1915
SBBR,UMMS,2,1692,493,2185
SBBR,UMMS,1,1212,126,1338
SBBR,UMMS,1,1212,580,1792
SBBR,UMMS,2,1747,597,2344
SBBR,UMMS,1,1212,565,1777
SBBR,UMMS,1,1212,680,1892
SBBR,UMMS,1,1212,465,1677
SBBR,UMMS,2,1756,581,2337
SBBR,UMMS,2,1698,346,2044
SBBR,UMMS,2,1755,449,2204
SBBR,UMMS,2,1764,1054,2818
SBBR,UMMS,2,1749,54,1803
SBBR,UMMS,1,1212,709,1921
SBBR,UMMS,2,1691,495,2186
SBBR,UMMS,2,1695,169,1864
SBBR,UMMS,2,1707,454,2161
SBBR,UMMS,1,1200,7,1207
SBBR,UMMS,2,1757,1036,2793
SBBR,UMMS,1,1212,522,1734
SBBR,UMMS,2,1759,395,2154
SBBR,UMMS,2,1755,447,2202
SBBR,UMMS,1,1200,849,2049
SBBR,UMMS,2,1761,765,2526
SBBR,UMMS,2,1762,613,2375
SBBR,UMMS,1,1212,623,1835
SBBR,UMMS,1,1212,842,2054
SBBR,UMMS,2,1755,404,2159
SBBR,UMMS,3,2237,531,2768
SBBR,UMMS,1,1200,281,1481
SBBR,UMMS,1,1200,742,1942
SBBR,UMMS,2,1744,605,2349
SBBR,UMMS,2,1755,320,2075
SBBR,UMMS,1,1200,558,1758
SBBR,UMMS,2,1766,355,2121
SBBR,UMMS,2,1755,259,2014
SBBR,UMMS,1,1212,273,1485
SBBR,UMMS,2,1753,495,2248
SBBR,UMMS,1,1212,250,1462
SBBR,UMMS,2,1695,313,2008
SBBR,UMMS,1,1212,909,2121
SBBR,UMMS,2,1695,550,2245
SBBR,UMMS,1,1200,873,2073
SBBR,UMMS,2,1755,266,2021
SBBR,UMMS,2,1748,192,1940
SBBR,UMMS,1,1212,977,2189
SBBR,UMMS,2,1755,249,2004
SBBR,UMMS,1,1200,607,1807
SBBR,UMMS,2,1766,326,2092
SBBR,UMMS,2,1755,348,2103
SBBR,UMMS,1,1212,576,1788
SBBR,UMMS,1,1212,165,1377
SBBR,UMMS,2,1698,148,1846
SBBR,UMMS,1,1200,584,1784
SBBR,UMMS,1,1200,121,1321
SBBR,UMMS,2,1743,391,2134
SBBR,UMMS,1,1212,644,1856
SBBR,UMMS,2,1752,492,2244
SBBR,UMMS,2,1758,256,2014
SBBR,UMMS,2,1743,502,2245
SBBR,UMMS,1,1200,242,1442
SBBR,UMMS,2,1748,500,2248
SBBR,UMMS,2,1747,570,2317
SBBR,UMMS,1,1212,973,2185
SBBR,UMMS,2,1760,330,2090
SBBR,UMMS,1,1212,71,1283
SBBR,UMMS,2,1752,199,1951
SBBR,UMMS,2,1749,346,2095
SBBR,UMMS,1,1212,993,2205
SBBR,UMMS,2,1764,683,2447
SBBR,UMMS,1,1200,333,1533
SBBR,UMMS,1,1212,157,1369
SBBR,UMMS,2,1692,349,2041
SBBR,UMMS,2,1761,715,2476
SBBR,UMMS,1,1212,1027,2239
SBBR,UMMS,2,1746,701,2447
SBBR,UMMS,2,1755,534,2289
SBBR,UMMS,1,1200,22,1222
SBBR,UMMS,2,1741,338,2079
SBBR,UMMS,2,1698,422,2120
SBBR,UMMS,1,1200,645,1845
SBBR,UMMS,1,1212,620,1832
SBBR,UMMS,2,1749,613,2362
SBBR,UMMS,2,1861,122,1983
SBBR,UMMS,2,1759,430,2189
SBBR,UMMS,1,1212,278,1490
SBBR,UMMS,2,1692,214,1906
SBBR,UMMS,1,1212,389,1601
SBBR,UMMS,2,1760,672,2432
SBBR,UMMS,2,1759,352,2111
SBBR,UMMS,2,1746,313,2059
SBBR,UMMS,1,1212,1012,2224
SBBR,UMMS,1,1212,582,1794
SBBR,UMMS,1,1200,531,1731
SBBR,UMMS,2,1760,823,2583
SBBR,UMMS,2,1695,352,2047
SBBR,UMMS,2,1875,309,2184
SBBR,UMMS,1,1200,629,1829
SBBR,UMMS,2,1758,246,2004
SBBR,UMMS,2,1747,319,2066
SBBR,UMMS,2,1743,593,2336
SBBR,UMMS,2,1999,533,2532
SBBR,UMMS,1,1200,420,1620
SBBR,UMMS,2,1754,653,2407
SBBR,UMMS,2,1702,309,2011
SBBR,UMMS,1,1212,506,1718
SBBR,UMMS,2,1755,248,2003
SBBR,UMMS,2,1748,581,2329
SBBR,UMMS,2,1695,229,1924
SBBR,UMMS,2,1698,482,2180
SBBR,UMMS,1,1200,838,2038
SBBR,UMMS,2,1698,255,1953
SBBR,UMMS,1,1212,133,1345
SBBR,UMMS,2,1758,946,2704
SBBR,UMMS,2,1748,377,2125
SBBR,UMMS,2,1753,558,2311
SBBR,UMMS,1,1200,434,1634
SBBR,UMMS,2,1692,192,1884
SBBR,UMMS,2,1741,200,1941
SBBR,UMMS,2,1868,368,2236
SBBR,UMMS,1,1212,389,1601
SBBR,UMMS,2,1748,188,1936
SBBR,UMMS,2,1753,752,2505
SBBR,UMMS,1,1200,653,1853
SBBR,UMMS,2,1748,125,1873
SBBR,UMMS,1,1200,805,2005
SBBR,UMMS,1,1212,553,1765
SBBR,UMMS,2,1752,487,2239
SBBR,UMMS,3,2228,259,2487
SBBR,UMMS,2,1695,819,2514
SBBR,UMMS,2,1743,192,1935
SBBR,UMMS,2,1762,389,2151
SBBR,UMMS,2,1758,444,2202
SBBR,UMMS,2,1698,405,2103
SBBR,UMMS,2,1875,626,2501
SBBR,UMMS,2,1752,287,2039
SBBR,UMMS,2,1748,523,2271
SBBR,UMMS,1,1200,103,1303
SBBR,UMMS,2,1752,484,2236
SBBR,UMMS,2,1754,380,2134
SBBR,UMMS,2,1744,597,2341
SBBR,UMMS,2,1698,313,2011
SBBR,UMMS,2,1697,467,2164
SBBR,UMMS,1,1212,334,1546
SBBR,UMMS,1,1212,521,1733
SBBR,UMMS,2,1760,448,2208
SBBR,UMMS,2,1691,132,1823
SBBR,UMMS,2,1758,485,2243
SBBR,UMMS,2,1691,594,2285
SBBR,UMMS,1,1200,936,2136
SBBR,UMMS,1,1200,825,2025
SBBR,UMMS,2,1752,432,2184
SBBR,UMMS,1,1200,863,2063
SBBR,UMMS,2,1762,782,2544
SBBR,UMMS,1,1212,486,1698
SBBR,UMMS,2,1695,369,2064
SBBR,UMMS,2,1754,430,2184
SBBR,UMMS,2,1696,663,2359
SBBR,UMMS,1,1212,499,1711
SBBR,UMMS,1,1200,376,1576
SBBR,UMMS,1,1212,775,1987
SBBR,UMMS,2,1861,225,2086
SBBR,UMMS,2,1754,195,1949
SBBR,UMMS,1,1212,172,1384
SBBR,UMMS,2,1755,220,1975
SBBR,UMMS,1,1200,695,1895
SBBR,UMMS,2,1750,222,1972
SBBR,UMMS,2,1756,177,1933
SBBR,UMMS,2,1695,369,2064
SBBR,UMMS,2,1754,204,1958
SBBR,UMMS,1,1200,992,2192
SBBR,UMMS,1,1212,895,2107
SBBR,UMMS,2,1754,593,2347
SBBR,UMMS,2,1758,620,2378
SBBR,UMMS,1,1212,1092,2304
SBBR,UMMS,2,1692,289,1981
SBBR,UMMS,1,1212,7,1219
SBBR,UMMS,2,1752,636,2388
SBBR,UMMS,1,1212,406,1618
SBBR,UMMS,2,1762,217,1979
SBBR,UMMS,2,1698,307,2005
SBBR,UMMS,1,1212,385,1597
SBBR,UMMS,2,1702,139,1841
SBBR,UMMS,2,1861,74,1935
SBBR,UMMS,1,1200,706,1906
SBBR,UMMS,2,1755,562,2317
SBBR,UMMS,1,1212,598,1810
SBBR,UMMS,2,1748,548,2296
SBBR,UMMS,1,1212,1085,2297
SBBR,UMMS,3,2237,559,2796
SBBR,UMMS,2,1754,790,2544
SBBR,UMMS,1,1212,533,1745
SBBR,UMMS,2,1695,131,1826
SBBR,UMMS,2,1691,448,2139
SBBR,UMMS,1,1200,674,1874
SBBR,UMMS,2,1695,323,2018
SBBR,UMMS,2,1744,560,2304
SBBR,UMMS,1,1200,313,1513
SBBR,UMMS,2,1758,485,2243
SBBR,UMMS,2,1758,397,2155
SBBR,UMMS,1,1212,138,1350
SBBR,UMMS,1,1200,483,1683
SBBR,UMMS,1,1200,135,1335
SBBR,UMMS,1,1200,1000,2200
SBBR,UMMS,1,1200,175,1375
SBBR,UMMS,1,1200,959,2159
SBBR,UMMS,2,1697,912,2609
SBBR,UMMS,2,1752,598,2350
SBBR,UMMS,2,1758,449,2207
SBBR,UMMS,1,1200,0,1200
SBBR,UMMS,2,1742,957,2699
SBBR,UMMS,1,1200,66,1266
SBBR,UMMS,1,1200,597,1797
